"agent_A","agent_B","contact","date_start","date_stop","duration","dist_min","dist_mean","dist_max"
0,1,0,669,675,6,9.41,11.26,13.82
0,1,1,1014,1019,5,10.34,11.79,13.72
0,2,0,979,986,7,4.55,8.99,14.49
0,4,0,922,932,10,9.28,11.36,14.66
0,5,0,756,757,1,14.57,14.62,14.68
0,5,1,1006,1014,8,5.76,9.51,13.96
0,6,0,471,477,6,6.35,10.49,14.62
0,6,1,899,913,14,0.7,7.61,14.69
0,6,2,1037,1051,14,7.14,10.01,14.02
0,7,0,536,551,15,8.87,10.94,14.04
0,7,1,629,638,9,1.93,7.3,12.92
0,7,2,741,750,9,5.87,9.53,14.98
0,8,0,664,674,10,3.98,8.53,13.94
0,8,1,770,778,8,3.98,9.05,14.82
0,8,2,887,894,7,11.36,12.49,14.21
0,9,0,807,813,6,12.76,13.7,14.86
0,9,1,833,876,43,4.69,8.94,14.99
0,9,2,913,922,9,7.88,10.53,14.59
0,10,0,1001,1010,9,7.32,10.42,14.89
0,11,0,566,576,10,0.94,7.34,13.86
0,11,1,798,806,8,9.35,11.45,14.46
0,12,0,618,628,10,9.02,11.44,14.9
0,14,0,576,584,8,3.96,8.7,14.19
0,14,1,1049,1054,5,12.27,13.24,14.82
1,0,0,669,675,6,9.41,11.26,13.82
1,0,1,1014,1019,5,10.34,11.79,13.72
1,2,0,939,943,4,12.02,12.94,13.85
1,3,0,770,782,12,0.37,7.89,14.83
1,4,0,726,752,26,3.41,10.07,14.99
1,5,0,458,473,15,5.11,9.26,14.93
1,5,1,776,795,19,3.11,7.96,13.79
1,7,0,611,625,14,2.84,8.44,14.92
1,7,1,763,764,1,14.79,14.87,14.94
1,7,2,915,928,13,4.89,9.02,14.88
1,8,0,664,693,29,2.32,8.03,14.71
1,8,1,934,942,8,4.17,9.14,14.5
1,9,0,566,570,4,12.77,13.74,14.9
1,9,1,701,702,1,14.75,14.78,14.8
1,10,0,926,933,7,9.41,11.02,13.13
1,11,0,449,458,9,0.51,6.56,14.66
1,12,0,514,515,1,14.75,14.78,14.81
1,12,1,835,844,9,4.71,8.67,13.46
1,13,0,452,457,5,10.73,12.07,13.85
1,13,1,699,706,7,3.87,8.66,14.33
1,13,2,863,868,5,8.52,10.48,13.11
1,14,0,1001,1007,6,7.03,9.57,12.51
2,0,0,979,986,7,4.55,8.99,14.49
2,1,0,939,943,4,12.02,12.94,13.85
2,3,0,499,506,7,8.97,11.44,14.63
2,3,1,912,919,7,7.25,10.12,13.81
2,4,0,447,451,4,6.82,10.76,14.71
2,4,1,633,641,8,11.94,12.98,14.51
2,4,2,1049,1051,2,11.86,13.27,14.7
2,5,0,500,509,9,0.71,7.62,14.65
2,5,1,685,690,5,9.99,11.66,14.06
2,6,0,602,607,5,14.26,14.52,14.89
2,6,1,853,863,10,6.8,9.94,14.86
2,7,0,688,696,8,6.75,10.14,14.79
2,7,1,793,798,5,12.34,13.34,14.77
2,7,2,1005,1013,8,6.36,9.87,14.56
2,8,0,501,502,1,14.41,14.42,14.43
2,8,1,601,608,7,5.89,9.78,14.41
2,8,2,931,936,5,12.53,13.19,14.02
2,9,0,602,609,7,10.66,12.43,14.96
2,11,0,637,643,6,11.67,13,14.97
2,11,1,954,962,8,2.42,7.61,13.4
2,12,0,778,787,9,2.66,8.52,13.53
2,13,0,528,537,9,10.22,12.14,14.95
2,13,1,646,649,3,14.22,14.41,14.62
2,13,2,993,998,5,9.79,11.74,14.32
2,14,0,521,528,7,2.92,7.86,13.47
2,14,1,612,617,5,12.43,13.43,14.67
3,1,0,770,782,12,0.37,7.89,14.83
3,2,0,499,506,7,8.97,11.44,14.63
3,2,1,912,919,7,7.25,10.12,13.81
3,5,0,495,505,10,0.63,7.04,12.92
3,5,1,756,777,21,6.82,9.94,14.56
3,6,0,683,684,1,12.72,13.5,14.27
3,7,0,724,731,7,9.96,11.87,14.39
3,8,0,442,448,6,6.4,10.39,14.61
3,8,1,489,519,30,7.82,10.48,14.72
3,8,2,540,559,19,1.51,7.96,14.88
3,8,3,839,848,9,0.93,7.38,13.89
3,9,0,508,515,7,7.7,10.36,14.11
3,10,0,821,861,40,1.03,7.53,14.62
3,11,0,483,493,10,0.28,7.89,14.48
3,12,0,799,807,8,2.22,8.03,14.46
3,13,0,684,691,7,9.66,11.69,14.71
3,13,1,787,795,8,1.59,7.59,14.89
3,13,2,892,895,3,13.44,13.82,14.31
3,14,0,719,729,10,1.56,7.92,14.73
3,66,0,1011,1027,16,6.81,10.13,14.71
3,302,0,957,966,9,4.82,9.09,14.26
3,307,0,1016,1025,9,11.68,12.84,14.85
3,308,0,1025,1040,15,6.85,10.17,14.85
3,343,0,951,951,0,11.65,11.65,11.65
4,0,0,922,932,10,9.28,11.36,14.66
4,1,0,726,752,26,3.41,9.88,14.42
4,2,0,633,641,8,11.94,12.98,14.51
4,2,1,1049,1058,9,11.86,13.51,14.94
4,3,0,1070,1079,9,4.32,4.58,5.18
4,5,0,986,986,0,14.98,14.98,14.98
4,7,0,824,837,13,8.02,10.65,14.42
4,8,0,559,575,16,2.2,8.04,14.75
4,10,0,465,474,9,9.9,11.54,14.89
4,11,0,587,600,13,9.55,11.68,15
4,11,1,633,659,26,4.22,8.68,14.47
4,11,2,744,758,14,6.69,9.73,14.07
4,12,0,673,683,10,8.15,10.62,14.12
4,13,0,659,675,16,5.84,10.32,14.95
4,13,1,950,961,11,2.25,7.75,13.77
4,14,0,891,907,16,3.58,8.5,14.72
5,0,0,756,757,1,14.57,14.62,14.68
5,0,1,1006,1014,8,5.76,9.51,13.96
5,1,0,776,795,19,3.11,7.96,13.79
5,2,0,500,509,9,0.71,7.62,14.65
5,2,1,685,690,5,9.99,11.66,14.06
5,3,0,495,505,10,0.63,7.04,12.92
5,3,1,756,777,21,6.82,9.94,14.56
5,4,0,986,986,0,14.98,14.98,14.98
5,6,0,966,966,0,11.24,11.24,11.24
5,7,0,476,484,8,8.19,10.52,13.61
5,7,1,678,693,15,9.58,11.59,14.96
5,8,0,490,502,12,0.34,7.16,13.36
5,8,1,740,748,8,1.24,7.63,14.63
5,9,0,532,540,8,8.32,10.71,13.73
5,10,0,632,641,9,12.05,12.98,14.51
5,10,1,1010,1016,6,11.21,12.33,13.83
5,12,0,710,717,7,3.78,8.01,12.92
5,13,0,1020,1028,8,4.36,8.96,13.93
5,14,0,993,998,5,12.24,13.35,14.95
5,176,0,880,880,0,5.4,5.4,5.4
5,244,0,901,909,8,0.83,8.04,14.66
5,297,0,859,859,0,7.99,7.99,7.99
5,297,1,865,880,15,7.17,10.12,14.56
6,0,0,451,477,26,4.98,9.72,14.73
6,0,1,899,913,14,0.7,7.61,14.69
6,2,0,602,607,5,14.26,14.52,14.89
6,2,1,853,863,10,6.8,9.94,14.86
6,3,0,683,684,1,12.72,13.5,14.27
6,7,0,656,671,15,5.73,9.29,14.12
6,8,0,601,612,11,7.95,10.61,14.65
6,9,0,606,612,6,12.07,13.06,14.56
6,9,1,823,823,0,12.96,12.96,12.96
6,9,2,913,916,3,13.53,14.02,14.74
6,10,0,874,885,11,3.17,8.09,14.12
6,12,0,916,933,17,3.55,9.68,14.7
6,13,0,442,443,1,10.49,11.65,12.81
6,13,1,683,684,1,12.02,13.14,14.26
6,14,0,1012,1019,7,12.49,13.37,14.83
6,105,0,707,707,0,14.49,14.49,14.49
6,126,0,708,708,0,14.12,14.12,14.12
6,211,0,758,770,12,5.76,9.49,14.52
6,212,0,766,778,12,6.19,9.46,13.96
6,213,0,708,722,14,4.01,7.93,14.73
6,214,0,771,779,8,6.44,9.77,14.22
6,216,0,709,711,2,13.83,14.41,14.98
6,217,0,740,752,12,9.42,11.46,14.98
6,219,0,753,768,15,3.24,8.63,14.93
6,220,0,708,713,5,8.83,11.06,14.08
7,0,0,536,551,15,8.87,10.94,14.04
7,0,1,629,638,9,1.93,7.3,12.92
7,0,2,741,750,9,5.87,9.53,14.98
7,1,0,611,625,14,2.84,8.57,14.92
7,1,1,763,764,1,14.79,14.87,14.94
7,1,2,915,928,13,4.89,9.02,14.88
7,2,0,688,696,8,6.75,10.14,14.79
7,2,1,793,798,5,12.34,13.34,14.77
7,2,2,1005,1013,8,6.36,9.87,14.56
7,3,0,724,731,7,9.96,11.87,14.39
7,4,0,824,837,13,8.02,10.65,14.42
7,5,0,476,484,8,8.19,10.52,13.61
7,5,1,678,693,15,9.58,11.59,14.96
7,6,0,656,671,15,5.73,9.29,14.12
7,8,0,451,465,14,10.7,12.34,14.92
7,8,1,1024,1029,5,6.44,9.07,13.76
7,9,0,494,498,4,12.59,13.39,14.4
7,9,1,586,592,6,10.33,12.16,14.66
7,9,2,946,954,8,5.15,9.33,14.32
7,10,0,1021,1029,8,3.32,7.6,14.91
7,11,0,949,956,7,9.29,11.21,13.86
7,12,0,627,628,1,14.36,14.37,14.38
7,13,0,978,986,8,2.03,7.36,12.75
7,14,0,707,713,6,11.61,12.63,14.06
7,14,1,717,726,9,12.88,13.67,14.97
7,14,2,964,974,10,2.41,7.69,13.87
8,0,0,664,674,10,3.98,8.53,13.94
8,0,1,770,778,8,3.98,9.05,14.82
8,0,2,887,894,7,11.36,12.49,14.21
8,1,0,664,693,29,2.32,8.03,14.71
8,1,1,934,942,8,4.17,9.14,14.5
8,2,0,501,502,1,14.41,14.42,14.43
8,2,1,601,608,7,5.89,9.78,14.41
8,2,2,931,936,5,12.53,13.19,14.02
8,3,0,489,519,30,7.82,10.48,14.72
8,3,1,540,559,19,1.51,7.87,14.88
8,3,2,839,848,9,0.93,7.38,13.89
8,4,0,559,575,16,2.2,8.04,14.75
8,5,0,490,502,12,0.34,7.16,13.36
8,5,1,740,748,8,1.24,7.63,14.63
8,6,0,601,612,11,7.95,10.61,14.65
8,7,0,1024,1035,11,6.44,9.75,13.76
8,9,0,599,606,7,8.9,10.92,13.6
8,9,1,691,700,9,3.75,8.46,14.14
8,9,2,785,794,9,3.06,8.09,13.88
8,9,3,878,886,8,3.71,8.96,14.66
8,9,4,975,977,2,14.2,14.39,14.59
8,10,0,626,632,6,12.04,13.13,14.85
8,10,1,839,848,9,2.44,7.7,13.39
8,10,2,948,962,14,1.12,9.31,14.98
8,10,3,1020,1039,19,0.7,7.38,14.29
8,11,0,484,488,4,13.73,14.33,14.96
8,11,1,778,788,10,0.63,7.99,14.96
8,12,0,588,600,12,8.13,10.7,14.84
8,12,1,893,900,7,8.69,11.14,14.29
8,13,0,801,807,6,7,10,13.3
8,13,1,903,909,6,6.73,9.78,14.09
8,13,2,1009,1020,11,2.18,8.16,14.65
8,14,0,728,740,12,6.27,9.44,13.9
8,14,1,865,870,5,11.49,12.81,14.97
9,0,0,448,454,6,13.57,14.14,14.85
9,0,1,807,813,6,12.76,13.7,14.86
9,0,2,833,876,43,4.69,8.94,14.99
9,0,3,913,922,9,7.88,10.53,14.59
9,1,0,566,570,4,12.77,13.74,14.9
9,1,1,701,702,1,14.75,14.78,14.8
9,1,2,1031,1043,12,6.43,9.55,13.9
9,2,0,602,609,7,10.66,12.43,14.96
9,2,1,1059,1065,6,13.48,14.05,14.97
9,3,0,508,515,7,7.7,10.36,14.11
9,5,0,532,540,8,8.32,10.71,13.73
9,6,0,606,612,6,12.07,13.06,14.56
9,6,1,913,916,3,13.53,14.02,14.74
9,7,0,494,498,4,12.59,13.39,14.4
9,7,1,586,592,6,10.33,12.16,14.66
9,7,2,946,954,8,5.15,9.33,14.32
9,8,0,599,606,7,8.9,10.92,13.6
9,8,1,691,700,9,3.75,8.46,14.14
9,8,2,785,794,9,3.06,8.09,13.88
9,8,3,878,886,8,3.71,8.93,14.66
9,8,4,975,977,2,14.2,14.39,14.59
9,10,0,471,482,11,8.17,11.67,14.87
9,11,0,939,954,15,9.91,11.8,14.72
9,12,0,596,602,6,1.2,7.04,12.08
9,12,1,836,840,4,12.46,13.37,14.9
9,12,2,1015,1029,14,4.01,8.71,14.34
9,13,0,703,712,9,4.39,8.68,14.23
9,13,1,1028,1031,3,13.77,14.1,14.51
9,14,0,654,662,8,3.76,8.89,14.72
10,0,0,1001,1010,9,7.32,10.42,14.89
10,1,0,926,933,7,9.41,11.02,13.13
10,3,0,821,861,40,1.03,7.57,14.62
10,4,0,470,474,4,11.17,13.02,14.89
10,5,0,632,641,9,12.05,12.98,14.51
10,5,1,1010,1016,6,11.21,12.33,13.83
10,6,0,874,885,11,3.17,8.09,14.12
10,7,0,1021,1035,14,3.32,9.07,14.91
10,8,0,626,632,6,12.04,13.13,14.85
10,8,1,839,848,9,2.44,7.7,13.39
10,8,2,948,962,14,1.12,8.96,14.98
10,8,3,1020,1039,19,0.7,7.38,14.29
10,9,0,471,482,11,8.17,11.77,14.87
10,11,0,973,982,9,7.89,10.6,14.41
10,12,0,1066,1069,3,13.51,13.9,14.4
10,13,0,550,560,10,1.95,7.85,13.93
11,0,0,566,576,10,0.94,7.34,13.86
11,0,1,798,806,8,9.35,11.45,14.46
11,1,0,441,458,17,0.51,8.26,14.69
11,2,0,422,435,13,11.01,12.32,14.34
11,2,1,637,643,6,11.67,13,14.97
11,2,2,954,962,8,2.42,7.61,13.4
11,3,0,483,493,10,0.28,7.89,14.48
11,4,0,587,600,13,9.55,11.68,15
11,4,1,633,659,26,4.22,8.68,14.47
11,4,2,744,758,14,6.69,9.73,14.07
11,7,0,949,956,7,9.29,11.21,13.86
11,8,0,484,488,4,13.73,14.33,14.96
11,8,1,778,788,10,0.63,7.99,14.96
11,9,0,939,954,15,9.91,11.8,14.72
11,10,0,973,982,9,7.89,10.6,14.41
11,12,0,667,668,1,14.45,14.5,14.55
11,12,1,980,1006,26,4.81,8.82,14.96
11,13,0,452,470,18,6.87,9.98,14.73
11,13,1,505,521,16,2.06,8,14.96
11,13,2,1040,1042,2,14.36,14.56,14.73
11,14,0,540,559,19,1.83,7.7,14.21
11,14,1,765,775,10,5.88,9.22,13.52
11,14,2,904,920,16,1.15,7.79,14.4
12,0,0,618,628,10,9.02,11.44,14.9
12,1,0,514,515,1,14.75,14.78,14.81
12,1,1,835,844,9,4.71,8.67,13.46
12,2,0,422,422,0,14.86,14.86,14.86
12,2,1,778,787,9,2.66,8.53,13.53
12,3,0,799,807,8,2.22,8.03,14.46
12,4,0,422,427,5,9.95,11.82,14.58
12,4,1,673,683,10,8.15,10.62,14.12
12,5,0,710,717,7,3.78,8.01,12.92
12,6,0,427,441,14,3.82,8.74,14.8
12,6,1,916,933,17,3.55,9.77,14.7
12,7,0,627,628,1,14.36,14.37,14.38
12,7,1,1041,1048,7,12.77,13.54,14.72
12,8,0,588,600,12,8.13,10.7,14.84
12,8,1,893,900,7,8.69,11.14,14.29
12,9,0,596,602,6,1.2,7.04,12.08
12,9,1,836,840,4,12.46,13.37,14.9
12,9,2,1015,1029,14,4.01,8.71,14.34
12,10,0,422,427,5,3.46,8.44,13.43
12,10,1,1066,1069,3,13.51,13.9,14.4
12,11,0,667,668,1,14.45,14.5,14.55
12,11,1,980,1006,26,4.81,8.61,14.96
12,13,0,429,441,12,1.26,7.91,14.62
12,13,1,672,678,6,7.1,10.19,13.63
12,13,2,938,946,8,4.03,8.58,13.95
12,13,3,1026,1033,7,2.05,7.93,14.06
12,14,0,481,492,11,1.67,8.55,14.35
12,14,1,806,817,11,1.3,7.92,14.66
13,0,0,425,433,8,11.56,12.63,14.1
13,1,0,452,457,5,10.73,12.07,13.85
13,1,1,699,706,7,3.87,8.66,14.33
13,1,2,863,868,5,8.52,10.48,13.11
13,2,0,528,537,9,10.22,12.14,14.95
13,2,1,646,649,3,14.22,14.41,14.62
13,2,2,993,998,5,9.79,11.74,14.32
13,3,0,684,691,7,9.66,11.69,14.71
13,3,1,787,795,8,1.59,7.59,14.89
13,3,2,892,895,3,13.44,13.82,14.31
13,4,0,659,675,16,5.84,10.57,14.95
13,4,1,950,961,11,2.25,7.75,13.77
13,5,0,443,454,11,9.4,11.5,14.55
13,5,1,1020,1028,8,4.36,8.96,13.93
13,6,0,430,443,13,1.78,7.46,14.09
13,6,1,683,684,1,12.02,13.14,14.26
13,7,0,978,986,8,2.03,7.36,12.75
13,8,0,801,807,6,7,10,13.3
13,8,1,903,909,6,6.73,9.78,14.09
13,8,2,1009,1020,11,2.18,8.16,14.65
13,9,0,703,712,9,4.39,8.68,14.23
13,9,1,1028,1031,3,13.77,14.1,14.51
13,10,0,550,560,10,1.95,7.85,13.93
13,11,0,452,470,18,6.87,9.98,14.73
13,11,1,505,521,16,2.06,8.22,14.96
13,11,2,1040,1042,2,14.36,14.56,14.73
13,12,0,429,441,12,1.26,7.91,14.62
13,12,1,672,678,6,7.1,10.19,13.63
13,12,2,938,946,8,4.03,8.58,13.95
13,12,3,1026,1033,7,2.05,7.93,14.06
13,14,0,793,800,7,1.24,7.14,13.05
14,0,0,576,584,8,3.96,8.7,14.19
14,0,1,1049,1054,5,12.27,13.24,14.82
14,1,0,1001,1007,6,7.03,9.57,12.51
14,2,0,521,528,7,2.92,7.86,13.47
14,2,1,612,617,5,12.43,13.43,14.67
14,3,0,719,729,10,1.56,7.92,14.73
14,4,0,891,907,16,3.58,8.47,14.72
14,5,0,993,998,5,12.24,13.35,14.95
14,6,0,1012,1019,7,12.49,13.37,14.83
14,6,1,1047,1061,14,3.59,7.42,13.73
14,7,0,707,713,6,11.61,12.63,14.06
14,7,1,717,726,9,12.88,13.67,14.97
14,7,2,964,974,10,2.41,7.69,13.87
14,8,0,728,740,12,6.27,9.44,13.9
14,8,1,865,870,5,11.49,12.81,14.97
14,9,0,654,662,8,3.76,8.32,14.72
14,11,0,540,559,19,1.83,7.7,14.21
14,11,1,765,775,10,5.88,9.22,13.52
14,11,2,904,920,16,1.15,7.69,14.4
14,12,0,481,492,11,1.67,8.51,14.35
14,12,1,806,817,11,1.3,7.92,14.66
14,13,0,793,800,7,1.24,7.14,13.05
15,16,0,900,915,15,3.09,8.42,14.9
15,16,1,920,924,4,12.8,13.5,14.25
15,17,0,514,522,8,7.85,10.81,14.9
15,17,1,906,913,7,7.14,10.3,14.62
15,18,0,628,633,5,13.87,14.22,14.67
15,19,0,547,556,9,4.65,8.54,13.16
15,20,0,764,767,3,13.72,14.17,14.76
15,21,0,470,486,16,3.45,8.39,14.6
15,22,0,584,592,8,8.41,10.71,14.02
15,22,1,685,695,10,3.02,8.36,14.11
15,22,2,728,773,45,11.59,12.82,14.98
15,23,0,601,610,9,8.51,10.64,13.73
15,23,1,851,853,2,13.34,13.66,13.86
15,24,0,677,684,7,4.62,8.79,13.74
15,26,0,748,759,11,5.15,8.78,13.37
15,27,0,472,480,8,6.96,9.91,13.54
15,27,1,569,584,15,1.49,7.65,14.5
15,28,0,772,784,12,3.05,8.47,14.98
15,29,0,567,582,15,4.38,8.79,14.1
15,29,1,1021,1028,7,12.77,13.64,14.83
15,92,0,755,762,7,1.36,7.29,13.3
15,112,0,770,788,18,4,8.7,14.77
15,145,0,776,785,9,7.74,10.23,13.61
16,15,0,900,915,15,3.09,8.42,14.9
16,15,1,920,924,4,12.8,13.5,14.25
16,17,0,789,796,7,1.63,6.9,12.21
16,17,1,905,915,10,2.69,7.95,14.15
16,20,0,560,573,13,0.64,7.45,14.28
16,20,1,725,734,9,6.26,10.14,14.94
16,20,2,944,951,7,6.43,9.31,12.84
16,21,0,495,512,17,6.44,9.79,14.84
16,21,1,952,960,8,3.75,8.13,13.15
16,22,0,558,565,7,5.43,8.76,12.86
16,22,1,999,1002,3,12.82,13.58,14.76
16,23,0,489,495,6,10.26,11.96,14.19
16,23,1,759,778,19,3.75,9.89,14.43
16,23,2,950,957,7,2.99,8.12,13.73
16,23,3,1050,1056,6,13.15,13.71,14.6
16,24,0,537,557,20,1,9.8,14.91
16,24,1,818,824,6,8.9,10.85,13.58
16,25,0,530,536,6,9.28,11.46,14.2
16,25,1,773,777,4,10.17,11.52,12.96
16,25,2,932,933,1,14.77,14.83,14.9
16,25,3,1013,1015,2,14.31,14.59,14.83
16,26,0,878,887,9,4.56,9.08,14.39
16,27,0,636,641,5,8.93,10.78,13.16
16,27,1,868,873,5,8.1,10.01,12.26
16,28,0,987,1004,17,6.2,10.79,14.17
16,29,0,849,860,11,6.85,9.96,14.48
16,112,0,719,719,0,11.56,11.56,11.56
16,333,0,875,887,12,2.7,8.1,14.61
17,15,0,514,522,8,7.85,10.81,14.9
17,15,1,906,913,7,7.14,10.3,14.62
17,16,0,789,796,7,1.63,6.9,12.21
17,16,1,905,915,10,2.69,7.95,14.15
17,18,0,554,567,13,4.02,8.29,13.59
17,18,1,816,827,11,4.95,9.15,14.88
17,18,2,837,857,20,1.96,7.91,14.8
17,19,0,493,503,10,6.9,9.79,13.6
17,19,1,688,696,8,9.91,11.72,13.79
17,19,2,839,840,1,14.73,14.76,14.78
17,20,0,715,721,6,6.9,9.94,13.98
17,22,0,731,736,5,9.47,11.46,14.45
17,22,1,889,894,5,8.41,10.46,13.18
17,24,0,722,729,7,3.88,8.77,14.25
17,25,0,741,746,5,10.1,11.47,13.31
17,28,0,551,564,13,1.03,7.02,13.02
17,48,0,723,729,6,12.36,13.33,14.74
17,49,0,650,660,10,4.74,9.16,14.38
17,92,0,782,790,8,0.55,7.83,14.37
17,107,0,840,845,5,12.27,13.23,14.6
17,296,0,617,650,33,7.71,9.99,14.92
18,15,0,628,633,5,13.87,14.22,14.67
18,17,0,554,567,13,4.02,8.29,13.59
18,17,1,816,827,11,4.95,9.15,14.88
18,17,2,837,857,20,1.96,7.91,14.8
18,19,0,805,821,16,10.07,11.75,14.37
18,21,0,525,542,17,4.27,8.55,14.28
18,21,1,684,703,19,12.79,13.53,14.86
18,21,2,762,785,23,6.05,9.52,14.48
18,21,3,1010,1015,5,14.68,14.81,14.99
18,21,4,1035,1058,23,5.26,8.34,14.84
18,22,0,522,538,16,2.61,7.86,14.54
18,22,1,647,656,9,8.68,10.76,13.77
18,23,0,738,745,7,12.17,13.25,14.84
18,23,1,992,1003,11,4.71,9.2,14.75
18,24,0,504,518,14,7.24,10.26,14.66
18,24,1,898,909,11,1.45,7.64,14.04
18,25,0,477,488,11,9.98,11.82,14.57
18,26,0,480,505,25,0.8,7.53,14.33
18,26,1,785,808,23,0.56,7.17,14.46
18,27,0,680,691,11,6.18,9.31,13.48
18,28,0,540,569,29,6.67,9.91,14.81
18,28,1,654,676,22,4.25,8.74,14.88
18,92,0,739,739,0,8.15,8.15,8.15
18,107,0,836,846,10,2.9,7.5,14.52
18,266,0,856,867,11,7.49,10.96,14.5
18,333,0,865,865,0,2.18,2.18,2.18
19,15,0,547,556,9,4.65,8.54,13.16
19,17,0,493,503,10,6.9,9.79,13.6
19,17,1,689,696,7,9.91,11.52,13.79
19,17,2,839,840,1,14.73,14.76,14.78
19,18,0,805,821,16,10.07,11.75,14.37
19,20,0,1047,1050,3,8.97,11.49,14.24
19,21,0,789,801,12,2.05,8.2,14.1
19,22,0,965,973,8,3.18,7.79,12.84
19,23,0,579,581,2,14.47,14.68,14.8
19,25,0,614,622,8,0.89,7.24,13.69
19,26,0,600,609,9,2.79,7.73,13.21
19,27,0,643,646,3,13.67,14.09,14.65
19,28,0,844,855,11,3.83,8.63,14.59
19,123,0,845,845,0,11.19,11.19,11.19
19,145,0,740,765,25,5.78,9.43,14.43
19,266,0,855,855,0,11.94,11.94,11.94
20,15,0,764,767,3,13.72,14.17,14.76
20,16,0,560,573,13,0.64,7.45,14.28
20,16,1,725,734,9,6.26,10.14,14.94
20,16,2,944,951,7,6.43,9.31,12.84
20,17,0,715,721,6,6.9,9.94,13.98
20,19,0,1047,1056,9,8.97,11.51,14.53
20,21,0,642,653,11,3.79,8.85,14.82
20,21,1,977,988,11,1.91,7.98,14.4
20,22,0,546,564,18,3.77,8.19,13.63
20,22,1,604,610,6,5.73,8.86,12.56
20,22,2,844,850,6,6.27,9.25,12.92
20,23,0,816,821,5,8.99,10.85,13.33
20,23,1,969,976,7,3.36,8.29,14.14
20,24,0,521,527,6,9.69,12.07,14.83
20,24,1,577,598,21,9.42,11.53,14.97
20,24,2,835,841,6,6.57,9.51,13.19
20,26,0,643,650,7,14.14,14.45,14.93
20,27,0,589,605,16,2.33,8.62,14.95
20,28,0,515,526,11,3.01,8.21,14.7
20,28,1,909,923,14,6.1,9.84,14.77
20,48,0,851,853,2,13.37,14.08,14.89
20,92,0,741,741,0,11.61,11.61,11.61
20,123,0,867,872,5,10.64,12.09,14.17
21,15,0,470,486,16,3.45,8.39,14.6
21,16,0,495,512,17,6.44,9.79,14.84
21,16,1,952,960,8,3.75,8.13,13.15
21,18,0,525,542,17,4.27,8.55,14.28
21,18,1,684,703,19,12.79,13.53,14.86
21,18,2,762,785,23,6.05,9.52,14.48
21,18,3,1010,1015,5,14.68,14.81,14.99
21,18,4,1035,1043,8,5.26,9.9,14.84
21,19,0,789,801,12,2.05,7.84,14.1
21,20,0,642,653,11,3.79,8.85,14.82
21,20,1,977,988,11,1.91,7.98,14.4
21,22,0,494,516,22,9.73,11.71,14.86
21,22,1,526,539,13,0.65,7.49,14.35
21,23,0,620,627,7,7.34,9.85,13.24
21,23,1,747,754,7,8.9,11.13,14.31
21,23,2,864,874,10,7.44,10.06,13.81
21,23,3,937,960,23,6.39,9.59,14.22
21,23,4,987,993,6,12.85,13.6,14.52
21,25,0,816,827,11,10.58,12.37,15
21,25,1,845,861,16,12.7,13.44,14.66
21,25,2,867,877,10,4.74,8.91,14.89
21,26,0,510,520,10,4.72,9.46,14.93
21,26,1,648,655,7,10.16,11.91,14.38
21,26,2,779,790,11,6.18,9.35,13.54
21,27,0,472,481,9,3.05,8.1,14.37
21,27,1,917,937,20,3.5,8.42,14.67
21,28,0,535,542,7,11.38,12.42,13.88
21,28,1,670,681,11,8.98,11.24,14.82
21,28,2,803,815,12,2.78,8.01,14.45
21,29,0,902,921,19,0.61,7.67,14.91
22,15,0,584,592,8,8.41,10.71,14.02
22,15,1,685,695,10,3.02,8.84,14.11
22,15,2,728,773,45,11.59,12.82,14.98
22,16,0,558,565,7,5.43,8.76,12.86
22,16,1,999,1002,3,12.82,13.58,14.76
22,17,0,731,736,5,9.47,11.46,14.45
22,17,1,889,894,5,8.41,10.46,13.18
22,18,0,522,538,16,2.61,8.21,14.54
22,18,1,647,656,9,8.68,10.76,13.77
22,19,0,965,973,8,3.18,7.79,12.84
22,20,0,546,564,18,3.77,8.19,13.63
22,20,1,604,610,6,5.73,8.86,12.56
22,20,2,844,850,6,6.27,9.25,12.92
22,21,0,494,516,22,9.73,11.71,14.86
22,21,1,526,539,13,0.65,7.49,14.35
22,23,0,839,844,5,9.43,11.58,14.87
22,24,0,567,568,1,14.96,14.96,14.96
22,24,1,777,780,3,13.87,14.22,14.57
22,24,2,862,869,7,7.54,10.24,14.21
22,24,3,947,956,9,1.25,7.93,14.74
22,24,4,1034,1042,8,5.53,9.38,13.78
22,25,0,637,643,6,10.39,11.8,13.71
22,26,0,511,516,5,8.14,10.07,12.4
22,26,1,743,754,11,2.25,7.55,13.57
22,26,2,975,980,5,10.09,11.84,14.3
22,27,0,481,487,6,5.88,9.05,12.59
22,28,0,534,544,10,3.42,8.22,14.19
22,28,1,651,660,9,1.7,7.76,14.02
22,28,2,767,777,10,2.49,7.77,14.09
22,28,3,1000,1019,19,7.99,11.63,14.37
22,29,0,975,985,10,6.13,9.78,14.58
22,48,0,738,750,12,11.08,12.48,14.69
22,48,1,825,839,14,9.29,11.22,14.15
22,92,0,754,759,5,8.58,10.76,13.69
22,112,0,762,777,15,3.25,8.27,14.33
22,129,0,916,931,15,3.05,8.47,14.85
22,145,0,773,777,4,13.38,13.97,14.63
23,15,0,601,610,9,8.51,10.64,13.73
23,15,1,851,853,2,13.34,13.66,13.86
23,16,0,489,495,6,10.26,11.96,14.19
23,16,1,759,778,19,3.75,9.91,14.43
23,16,2,950,957,7,2.99,8.12,13.73
23,18,0,738,745,7,12.17,13.25,14.84
23,18,1,992,1003,11,4.71,9.2,14.75
23,19,0,579,581,2,14.47,14.68,14.8
23,20,0,816,821,5,8.99,10.85,13.33
23,20,1,969,976,7,3.36,8.29,14.14
23,21,0,620,627,7,7.34,9.85,13.24
23,21,1,747,754,7,8.9,11.13,14.31
23,21,2,864,874,10,7.44,10.06,13.81
23,21,3,937,960,23,6.39,9.59,14.22
23,21,4,987,993,6,12.85,13.6,14.52
23,22,0,839,844,5,9.43,11.58,14.87
23,24,0,830,837,7,2,8.02,14.05
23,25,0,770,777,7,4.15,9.06,14.6
23,25,1,871,872,1,14.82,14.89,14.96
23,26,0,666,672,6,4.67,8.39,12.21
23,27,0,695,703,8,0.33,8.03,14.67
23,27,1,793,802,9,3.64,8.5,14.27
23,27,2,932,943,11,6.46,9.97,14.82
23,28,0,690,699,9,8.8,11.23,14.97
23,92,0,739,739,0,10.48,10.48,10.48
23,92,1,789,799,10,7.85,10.8,14.67
23,107,0,911,927,16,4.35,9,14.84
24,15,0,678,684,6,4.62,8.09,13.02
24,16,0,537,557,20,1,9.92,14.91
24,16,1,818,824,6,8.9,10.85,13.58
24,17,0,722,729,7,3.88,8.77,14.25
24,18,0,504,518,14,7.24,10.51,14.66
24,18,1,898,909,11,1.45,7.64,14.04
24,20,0,521,527,6,9.69,12.07,14.83
24,20,1,577,598,21,9.42,11.53,14.97
24,20,2,835,841,6,6.57,9.51,13.19
24,22,0,458,460,2,12.02,12.99,14.05
24,22,1,567,568,1,14.96,14.96,14.96
24,22,2,777,780,3,13.87,14.22,14.57
24,22,3,862,869,7,7.54,10.24,14.21
24,22,4,947,956,9,1.25,7.93,14.74
24,22,5,1034,1042,8,5.53,9.38,13.78
24,23,0,830,837,7,2,8.02,14.05
24,25,0,529,536,7,10.02,11.71,13.94
24,26,0,503,507,4,11.97,13.07,14.15
24,26,1,614,627,13,1.15,8,14.95
24,27,0,588,610,22,6.5,10.92,14.54
24,27,1,847,854,7,5.29,9.36,14.72
24,28,0,520,531,11,1.14,7.75,14.47
24,28,1,641,649,8,0.75,6.84,12.12
24,28,2,761,763,2,14.22,14.37,14.48
24,48,0,722,737,15,6.74,9.83,14.43
24,48,1,804,822,18,2.49,8.09,14.83
24,92,0,746,752,6,4.63,8.66,14.01
24,145,0,761,769,8,8.39,10.96,14.59
25,15,0,1038,1058,20,0.91,8.85,14.57
25,16,0,530,536,6,9.28,11.46,14.2
25,16,1,773,777,4,10.17,11.52,12.96
25,16,2,932,933,1,14.77,14.83,14.9
25,16,3,1013,1015,2,14.31,14.59,14.83
25,17,0,741,746,5,10.1,11.47,13.31
25,18,0,477,488,11,9.98,11.82,14.57
25,19,0,614,622,8,0.89,7.24,13.69
25,21,0,816,827,11,10.58,12.37,15
25,21,1,845,861,16,12.7,13.44,14.66
25,21,2,867,877,10,4.74,8.91,14.89
25,22,0,637,643,6,10.39,11.8,13.71
25,23,0,770,777,7,4.15,9.06,14.6
25,23,1,871,872,1,14.82,14.89,14.96
25,24,0,529,536,7,10.02,11.71,13.94
25,26,0,479,489,10,1.09,7.38,13.69
25,26,1,704,709,5,12.61,13.38,14.49
25,27,0,459,464,5,10.26,12.06,14.89
25,27,1,626,631,5,11.6,12.81,14.49
25,27,2,1050,1058,8,3.69,8.58,13.39
25,28,0,500,510,10,5.5,9.53,14.27
25,28,1,817,819,2,14.43,14.6,14.72
25,112,0,828,843,15,3.75,8.46,14.9
25,123,0,887,898,11,1.17,8.04,14.96
26,15,0,748,759,11,5.15,8.78,13.37
26,16,0,878,887,9,4.56,9.08,14.39
26,18,0,480,505,25,0.8,7.62,14.33
26,18,1,785,808,23,0.56,6.81,14.46
26,19,0,600,609,9,2.79,7.73,13.21
26,20,0,643,650,7,14.14,14.45,14.93
26,21,0,510,520,10,4.72,9.46,14.93
26,21,1,648,655,7,10.16,11.91,14.38
26,21,2,779,790,11,6.18,9.35,13.54
26,21,3,1076,1077,1,12.63,13.43,14.23
26,22,0,511,516,5,8.14,10.07,12.4
26,22,1,743,754,11,2.25,7.55,13.57
26,22,2,975,980,5,10.09,11.84,14.3
26,23,0,666,672,6,4.67,8.39,12.21
26,24,0,503,507,4,11.97,13.07,14.15
26,24,1,614,627,13,1.15,8,14.95
26,25,0,479,489,10,1.09,7.38,13.69
26,25,1,704,709,5,12.61,13.38,14.49
26,27,0,918,923,5,13.04,13.85,14.94
26,29,0,962,983,21,6.63,9.99,14.92
26,48,0,739,749,10,1.77,7.84,13.89
26,92,0,758,763,5,12.26,13.2,14.68
26,92,1,852,853,1,13.7,14.31,14.93
26,129,0,844,858,14,3.13,8.89,13.46
26,333,0,867,867,0,10.83,10.83,10.83
26,333,1,874,903,29,1.71,8.22,14.56
27,15,0,472,480,8,6.96,9.91,13.54
27,15,1,569,584,15,1.49,7.52,14.5
27,15,2,1050,1059,9,1.1,7.21,14.12
27,16,0,636,641,5,8.93,10.78,13.16
27,16,1,868,873,5,8.1,10.01,12.26
27,18,0,433,445,12,4.5,7.89,14
27,18,1,680,691,11,6.18,9.31,13.48
27,19,0,643,646,3,13.67,14.09,14.65
27,20,0,589,605,16,2.33,8.35,14.95
27,21,0,472,481,9,3.05,8.1,14.37
27,21,1,917,937,20,3.5,8.42,14.67
27,22,0,481,487,6,5.88,9.05,12.59
27,23,0,695,703,8,0.33,8.03,14.67
27,23,1,793,802,9,3.64,8.5,14.27
27,23,2,932,943,11,6.46,9.97,14.82
27,24,0,588,610,22,6.5,10.86,14.54
27,24,1,847,854,7,5.29,9.36,14.72
27,25,0,459,464,5,10.26,12.06,14.89
27,25,1,626,631,5,11.6,12.81,14.49
27,25,2,1050,1058,8,2.2,7.97,13.39
27,26,0,918,923,5,13.04,13.85,14.94
27,28,0,433,437,4,12.35,13.42,14.9
27,28,1,698,709,11,13.1,13.7,14.67
27,29,0,561,586,25,4.33,7.98,14.74
27,29,1,722,732,10,11.8,12.96,14.98
27,29,2,742,751,9,12.61,13.43,14.91
27,29,3,1037,1044,7,12.15,13.07,14.44
27,92,0,797,832,35,0.43,6.88,14.91
27,112,0,721,726,5,13.22,13.77,14.57
28,15,0,772,784,12,3.05,8.47,14.98
28,16,0,987,1004,17,6.2,10.66,14.17
28,17,0,551,564,13,1.03,7.02,13.02
28,18,0,540,569,29,6.67,9.91,14.81
28,18,1,654,676,22,4.25,8.74,14.88
28,19,0,844,855,11,3.83,8.63,14.59
28,20,0,515,526,11,3.01,8.21,14.7
28,20,1,909,923,14,6.1,9.84,14.77
28,21,0,535,542,7,11.38,12.42,13.88
28,21,1,670,681,11,8.98,11.24,14.82
28,21,2,803,815,12,2.78,8.01,14.45
28,22,0,534,544,10,3.42,8.22,14.19
28,22,1,651,660,9,1.7,7.76,14.02
28,22,2,767,777,10,2.49,7.77,14.09
28,22,3,1000,1019,19,7.99,11.56,14.37
28,23,0,690,699,9,8.8,11.23,14.97
28,24,0,520,531,11,1.14,7.75,14.47
28,24,1,641,649,8,0.75,6.84,12.12
28,24,2,761,763,2,14.22,14.37,14.48
28,25,0,500,510,10,5.5,9.33,14.27
28,25,1,817,819,2,14.43,14.6,14.72
28,27,0,698,709,11,13.1,13.7,14.67
28,107,0,933,935,2,7.63,10.15,12.74
28,112,0,720,720,0,2.08,2.08,2.08
28,112,1,728,733,5,14.49,14.68,14.99
28,112,2,759,791,32,6.68,9.87,14.82
28,123,0,846,846,0,7.61,7.61,7.61
28,145,0,771,795,24,3.49,8.48,14.99
28,266,0,855,855,0,7.2,7.2,7.2
28,266,1,876,900,24,1.3,7.89,14.95
29,15,0,567,582,15,4.38,8.79,14.1
29,15,1,1021,1028,7,12.77,13.64,14.83
29,16,0,849,860,11,6.85,9.96,14.48
29,21,0,902,921,19,0.61,7.67,14.91
29,22,0,975,985,10,6.13,9.78,14.58
29,26,0,962,983,21,6.63,9.99,14.92
29,27,0,561,586,25,4.33,7.96,14.74
29,27,1,722,732,10,11.8,12.96,14.98
29,27,2,742,751,9,12.61,13.43,14.91
29,27,3,1037,1044,7,12.15,13.07,14.44
29,123,0,894,902,8,10.57,12.09,14.33
29,172,0,731,751,20,7.64,10.08,14.88
29,172,1,772,782,10,5.45,8.95,13.21
30,32,0,875,882,7,12.68,13.56,14.77
30,33,0,981,988,7,2.27,7.63,13.44
30,35,0,496,505,9,6.21,9.89,14.47
30,36,0,791,798,7,12.48,13.45,14.83
30,36,1,844,858,14,2.61,7.96,13.9
30,37,0,860,868,8,9.74,11.38,13.64
30,38,0,791,804,13,0.95,7.95,14.99
30,38,1,826,836,10,1.98,7.68,14.49
30,39,0,590,595,5,4.78,8.49,14.47
30,39,1,767,772,5,4.71,10.38,14.85
30,40,0,859,870,11,13.58,14.05,14.86
30,40,1,922,933,11,7.45,10.39,14.87
30,41,0,522,529,7,6.22,10.04,14.73
30,42,0,533,541,8,3.97,8.57,14.62
30,42,1,923,931,8,5.93,9.41,13.76
30,43,0,1020,1023,3,5.76,9.67,13.9
30,44,0,980,998,18,2.43,7.18,14.14
31,30,0,1036,1048,12,8.85,11.23,14.78
31,32,0,625,630,5,12.48,13.46,14.81
31,34,0,543,572,29,2.2,9.07,14.44
31,34,1,817,822,5,10.76,12.07,13.91
31,35,0,853,867,14,2.52,9.05,14.99
31,35,1,874,895,21,10.24,12,14.91
31,36,0,889,894,5,12.23,13.19,14.44
31,37,0,801,809,8,3.92,8.75,14.15
31,38,0,601,608,7,5.09,9.31,14.69
31,38,1,876,880,4,12.27,13,13.96
31,39,0,541,551,10,8.3,10.82,14.15
31,39,1,594,672,78,3.26,9.93,14.71
31,39,2,780,792,12,2.9,8.22,14.44
31,39,3,899,911,12,2.47,7.99,14.88
31,39,4,1020,1031,11,3.97,8.21,13.47
31,40,0,586,600,14,1.78,7.58,14.04
31,41,0,750,759,9,6.1,9.39,13.64
31,41,1,766,935,169,3.08,10.04,15
31,41,2,961,970,9,9.07,11.46,14.91
31,42,0,594,594,0,14.95,14.95,14.95
31,42,1,713,725,12,3.31,8.09,13.52
31,42,2,966,976,10,0.42,8.36,14.02
31,43,0,936,946,10,0.61,7.54,13.96
31,43,1,1042,1053,11,9.76,11.71,14.93
31,44,0,615,621,6,11.1,12.37,13.93
31,44,1,753,788,35,1.73,7.77,14.12
32,30,0,875,882,7,12.68,13.56,14.77
32,31,0,625,630,5,12.48,13.46,14.81
32,34,0,440,446,6,10.27,12.1,14.37
32,34,1,740,753,13,2.95,8.53,14.84
32,34,2,828,839,11,7,10.05,14.13
32,34,3,1001,1014,13,2.76,8.25,14.28
32,34,4,1054,1058,4,11.31,12.97,14.76
32,36,0,750,760,10,4.76,8.71,13.58
32,37,0,781,783,2,14.12,14.34,14.6
32,38,0,477,514,37,8.2,10.77,14.86
32,38,1,756,765,9,2.02,7.93,14.39
32,38,2,1045,1050,5,12.27,13.16,14.34
32,39,0,626,633,7,9.08,11.13,14.16
32,39,1,727,736,9,5.05,8.78,13.42
32,40,0,674,689,15,11.61,12.8,14.94
32,41,0,717,723,6,11.81,12.99,14.75
32,41,1,938,947,9,6.49,9.89,14.81
32,42,0,728,737,9,4.3,8.23,12.88
32,42,1,948,959,11,3.17,8.39,14.32
32,43,0,813,820,7,8.17,10.56,13.75
32,43,1,947,984,37,1.9,7.69,14.93
32,188,0,768,786,18,7.94,10.17,14.7
33,30,0,981,988,7,2.27,7.63,13.44
33,34,0,625,627,2,13.52,13.86,14.12
33,34,1,666,695,29,5,9.16,14.9
33,34,2,787,793,6,8.64,11.23,14.22
33,34,3,950,957,7,2.55,8.16,14.93
33,35,0,663,670,7,12.86,13.67,14.77
33,36,0,510,514,4,12.38,13.1,13.85
33,36,1,832,838,6,9.42,11.14,13.45
33,37,0,489,497,8,4.83,9.22,14.11
33,37,1,844,849,5,9.51,11.15,13.29
33,38,0,461,462,1,9.66,11.31,12.95
33,38,1,574,583,9,9.32,11.38,14.73
33,38,2,733,742,9,1.51,7.78,14.57
33,39,0,503,512,9,5.91,9.46,14.03
33,39,1,1005,1014,9,3.83,8.14,13.2
33,40,0,653,661,8,9.2,11.38,14.63
33,40,1,816,830,14,3.61,8.38,14.74
33,40,2,912,920,8,10.22,11.73,13.84
33,41,0,1012,1019,7,1.67,7.94,14.39
33,42,0,917,922,5,9.6,11.1,12.98
33,42,1,1027,1034,7,4.16,8.25,12.94
33,43,0,471,477,6,6.99,10.28,14.83
33,44,0,675,688,13,1.89,7.94,14.48
33,44,1,954,989,35,3.15,8.31,14.73
33,56,0,760,773,13,2.45,7.75,13.96
33,227,0,769,769,0,11.25,11.25,11.25
34,31,0,543,572,29,2.2,9.02,14.44
34,31,1,817,822,5,10.76,12.07,13.91
34,32,0,740,753,13,2.95,8.53,14.84
34,32,1,828,839,11,7,10.05,14.13
34,32,2,1001,1013,12,2.76,7.7,13.83
34,33,0,625,627,2,13.52,13.86,14.12
34,33,1,666,695,29,5,9.16,14.9
34,33,2,787,793,6,8.64,11.23,14.22
34,33,3,950,957,7,2.55,8.16,14.93
34,35,0,666,674,8,8.11,10.61,13.98
34,35,1,753,760,7,10.88,12.42,14.73
34,36,0,583,587,4,13.57,13.96,14.4
34,36,1,750,755,5,13.41,13.97,14.83
34,36,2,909,923,14,5.71,9.39,14.99
34,37,0,535,544,9,7.81,10.61,14.7
34,37,1,713,726,13,6.15,9.79,14.73
34,37,2,905,918,13,5.9,9.32,14.83
34,38,0,487,491,4,12.65,13.45,14.99
34,38,1,903,907,4,12.91,13.71,14.67
34,39,0,564,581,17,6.16,10.24,14.71
34,39,1,838,844,6,10.23,11.75,13.79
34,40,0,656,659,3,14.13,14.36,14.6
34,40,1,999,1006,7,10.46,11.84,13.79
34,41,0,502,510,8,14.41,14.63,14.96
34,41,1,815,822,7,3.63,7.7,12.24
34,42,0,889,897,8,4.94,8.97,13.48
34,43,0,488,495,7,7.67,10.6,14.34
34,44,0,677,694,17,2.24,7.93,14.84
34,44,1,944,954,10,5.64,9.03,14.09
34,227,0,811,814,3,8.91,11.09,13.4
35,30,0,496,505,9,6.21,9.89,14.47
35,31,0,853,867,14,2.52,9.04,14.99
35,31,1,874,895,21,10.24,12,14.91
35,33,0,663,670,7,12.86,13.67,14.77
35,34,0,666,674,8,8.11,10.61,13.98
35,34,1,753,760,7,10.88,12.42,14.73
35,36,0,625,629,4,13.47,14.2,14.99
35,36,1,711,715,4,12.83,13.59,14.77
35,36,2,886,887,1,14.64,14.65,14.65
35,37,0,589,595,6,8.14,10.91,14.2
35,38,0,872,879,7,0.83,7.19,13.62
35,39,0,529,537,8,4.22,9.19,14.83
35,40,0,451,464,13,9.1,11,14.56
35,40,1,533,541,8,9.93,11.82,14.27
35,40,2,774,780,6,12.05,13.05,14.86
35,41,0,599,605,6,9.66,11.64,14.88
35,41,1,853,863,10,4.25,9.99,14.73
35,41,2,866,890,24,4,8.57,14.81
35,42,0,605,613,8,3.93,9.01,14.92
35,42,1,777,785,8,1.1,7.33,13.51
35,42,2,812,828,16,7.84,10.5,14.76
35,43,0,589,594,5,10.04,11.8,14.17
35,43,1,1010,1013,3,12.87,13.57,14.56
36,30,0,791,798,7,12.48,13.45,14.83
36,30,1,844,858,14,2.61,7.96,13.9
36,31,0,889,894,5,12.23,13.19,14.44
36,32,0,750,760,10,4.76,8.71,13.58
36,33,0,510,514,4,12.38,13.1,13.85
36,33,1,832,838,6,9.42,11.14,13.45
36,34,0,583,587,4,13.57,13.96,14.4
36,34,1,750,755,5,13.41,13.97,14.83
36,34,2,909,923,14,5.71,9.39,14.99
36,35,0,625,629,4,13.47,14.2,14.99
36,35,1,711,715,4,12.83,13.59,14.77
36,35,2,886,887,1,14.64,14.65,14.65
36,37,0,557,557,0,14.78,14.78,14.78
36,37,1,888,924,36,7.74,11.23,14.89
36,37,2,1007,1015,8,7.16,10.26,14.99
36,38,0,616,624,8,6.07,9.5,14.31
36,38,1,760,798,38,5.38,9.35,14.94
36,38,2,902,909,7,7.95,10.31,13.56
36,39,0,576,586,10,3.23,8.55,14.68
36,39,1,987,993,6,11.18,12.54,14.25
36,40,0,450,459,9,11.79,12.81,14.4
36,40,1,611,624,13,9.13,11.23,14.68
36,41,0,885,894,9,3.65,8.56,14.63
36,44,0,639,653,14,1.01,7.68,14.59
36,44,1,928,942,14,3.45,8.3,14.41
37,30,0,860,868,8,9.74,11.38,13.64
37,31,0,801,809,8,3.92,8.75,14.15
37,32,0,781,783,2,14.12,14.34,14.6
37,33,0,489,497,8,4.83,9.22,14.11
37,33,1,844,849,5,9.51,11.15,13.29
37,34,0,535,544,9,7.81,10.61,14.7
37,34,1,713,726,13,6.15,9.79,14.73
37,34,2,905,918,13,5.9,9.65,14.83
37,35,0,589,595,6,8.14,10.91,14.2
37,36,0,557,557,0,14.78,14.78,14.78
37,36,1,888,923,35,7.74,11.14,14.89
37,36,2,1007,1015,8,7.16,10.26,14.99
37,38,0,661,668,7,1.8,7.22,12.7
37,38,1,902,909,7,2.37,7.68,13.66
37,39,0,461,467,6,9.38,11.31,13.66
37,39,1,548,553,5,11.24,12.64,14.73
37,39,2,888,894,6,9.47,11.37,14.29
37,39,3,973,980,7,3.77,8.02,12.95
37,40,0,556,568,12,3.23,8.53,14.7
37,41,0,547,558,11,13.46,14.06,14.99
37,41,1,798,806,8,7.05,10.58,14.92
37,41,2,891,895,4,11.26,12.28,13.5
37,42,0,629,630,1,14.76,14.85,14.94
37,43,0,579,614,35,0.47,7.67,14.01
37,44,0,698,708,10,3.94,8.41,14.09
37,44,1,886,909,23,6.25,9.71,14.99
37,44,2,921,932,11,0.78,7.31,13.86
37,44,3,1039,1044,5,13.83,14.15,14.58
37,188,0,778,782,4,12.5,13.49,14.53
38,30,0,791,804,13,0.95,7.95,14.99
38,30,1,826,836,10,1.98,7.68,14.49
38,31,0,601,608,7,5.09,9.31,14.69
38,31,1,876,880,4,12.27,13,13.96
38,32,0,477,514,37,8.2,10.78,14.86
38,32,1,756,765,9,2.02,7.93,14.39
38,32,2,1045,1050,5,12.27,13.16,14.34
38,33,0,450,462,12,4.21,8.02,13.37
38,33,1,574,583,9,9.32,11.38,14.73
38,33,2,733,742,9,1.51,7.78,14.57
38,34,0,487,491,4,12.65,13.45,14.99
38,34,1,903,907,4,12.91,13.71,14.67
38,34,2,1034,1047,13,7.68,10.37,14.53
38,35,0,872,879,7,0.83,7.19,13.62
38,36,0,616,624,8,6.07,9.5,14.31
38,36,1,760,798,38,5.38,9.35,14.94
38,36,2,902,909,7,7.95,10.31,13.56
38,37,0,661,668,7,1.8,7.22,12.7
38,37,1,902,909,7,2.37,7.68,13.66
38,40,0,610,619,9,12.31,13.34,14.87
38,40,1,1047,1051,4,6.84,10.26,13.74
38,41,0,872,881,9,3.92,8.72,14.76
38,42,0,501,508,7,12.31,13.45,14.96
38,43,0,492,493,1,14.74,14.84,14.94
38,43,1,861,866,5,10.56,12.18,14.28
38,44,0,546,556,10,8.65,11.1,14.76
38,44,1,560,574,14,13.02,13.71,14.97
38,44,2,905,916,11,0.95,7.94,14.96
39,30,0,590,595,5,4.78,8.49,14.47
39,30,1,768,772,4,4.71,9.65,14.85
39,31,0,541,551,10,8.3,10.82,14.15
39,31,1,594,660,66,7.61,10.12,14.71
39,31,2,663,672,9,3.26,7.53,13.92
39,31,3,780,792,12,2.9,8.22,14.44
39,31,4,899,911,12,2.47,7.99,14.88
39,31,5,1020,1031,11,3.97,8.21,13.47
39,32,0,626,633,7,9.08,11.13,14.16
39,32,1,727,736,9,5.05,8.78,13.42
39,33,0,503,512,9,5.91,9.46,14.03
39,33,1,1005,1014,9,3.83,8.14,13.2
39,34,0,564,580,16,6.16,10,14.35
39,34,1,838,844,6,10.23,11.75,13.79
39,34,2,1067,1069,2,10.78,12.47,14.16
39,35,0,529,537,8,4.22,8.98,14.83
39,36,0,576,586,10,3.23,8.55,14.68
39,36,1,987,993,6,11.18,12.54,14.25
39,37,0,461,467,6,9.38,11.31,13.66
39,37,1,548,553,5,11.24,12.64,14.73
39,37,2,888,894,6,9.47,11.37,14.29
39,37,3,973,980,7,3.77,8.02,12.95
39,38,0,1058,1069,11,8.22,10.1,13.86
39,40,0,517,531,14,4.16,8.45,13.75
39,40,1,1056,1066,10,11.93,13.07,14.89
39,41,0,552,558,6,9.32,11.63,14.43
39,41,1,651,659,8,7.49,10.08,13.38
39,41,2,787,788,1,14.82,14.89,14.95
39,41,3,895,906,11,3.3,8.06,13.58
39,42,0,729,744,15,3.23,8.21,14.21
39,43,0,736,745,9,5.97,9.62,14.69
39,44,0,782,795,13,9.39,11.47,14.68
39,44,1,882,895,13,3.27,8.38,14.79
40,30,0,859,870,11,13.58,14.05,14.86
40,30,1,922,933,11,7.45,10.39,14.87
40,31,0,586,600,14,1.78,7.58,14.04
40,32,0,674,689,15,11.61,12.8,14.94
40,33,0,653,661,8,9.2,11.38,14.63
40,33,1,816,830,14,3.61,8.38,14.74
40,33,2,912,920,8,10.22,11.73,13.84
40,34,0,656,659,3,14.13,14.36,14.6
40,34,1,999,1006,7,10.46,11.84,13.79
40,35,0,434,464,30,4.99,9.93,14.56
40,35,1,533,541,8,9.93,11.82,14.27
40,35,2,774,780,6,12.05,13.05,14.86
40,36,0,450,459,9,11.79,12.81,14.4
40,36,1,611,624,13,9.13,11.23,14.68
40,37,0,556,568,12,3.23,8.53,14.7
40,38,0,610,619,9,12.31,13.34,14.87
40,39,0,517,531,14,4.16,8.45,13.75
40,42,0,585,593,8,11.11,12.39,14.23
40,42,1,783,794,11,10.83,12.21,14.48
40,42,2,912,928,16,4.12,8.5,13.93
40,43,0,438,448,10,7.17,9.91,13.66
40,43,1,707,716,9,6.54,9.8,14.46
41,30,0,522,529,7,6.22,10.04,14.73
41,31,0,750,759,9,6.1,9.39,13.64
41,31,1,766,935,169,3.08,10.05,15
41,31,2,961,970,9,9.07,11.71,14.91
41,32,0,717,723,6,11.81,12.99,14.75
41,32,1,938,947,9,6.49,9.89,14.81
41,33,0,1012,1019,7,1.67,7.94,14.39
41,34,0,502,510,8,14.41,14.63,14.96
41,34,1,815,822,7,3.63,7.7,12.24
41,35,0,599,605,6,9.66,11.64,14.88
41,35,1,853,863,10,4.25,9.94,14.73
41,35,2,866,890,24,4,8.57,14.81
41,36,0,885,894,9,3.65,8.56,14.63
41,37,0,547,558,11,13.46,14.06,14.99
41,37,1,798,806,8,7.05,10.58,14.92
41,37,2,891,895,4,11.26,12.28,13.5
41,38,0,872,881,9,3.92,8.72,14.76
41,39,0,552,558,6,9.32,11.63,14.43
41,39,1,651,659,8,7.49,10.08,13.38
41,39,2,787,788,1,14.82,14.89,14.95
41,39,3,895,906,11,3.3,8.06,13.58
41,43,0,942,945,3,14.03,14.28,14.55
41,44,0,756,774,18,6.75,11.29,14.74
41,227,0,814,814,0,12.22,12.22,12.22
42,30,0,533,541,8,3.97,8.57,14.62
42,30,1,923,931,8,5.93,9.41,13.76
42,31,0,594,594,0,14.95,14.95,14.95
42,31,1,713,725,12,3.31,8.09,13.52
42,31,2,966,976,10,0.42,8.28,14.02
42,32,0,728,737,9,4.3,8.23,12.88
42,32,1,948,959,11,3.17,8.39,14.32
42,33,0,917,922,5,9.6,11.1,12.98
42,33,1,1027,1034,7,4.16,8.25,12.94
42,34,0,889,897,8,4.94,8.97,13.48
42,35,0,605,613,8,3.93,9.01,14.92
42,35,1,777,785,8,1.1,7.33,13.51
42,35,2,812,828,16,7.84,10.5,14.76
42,37,0,629,630,1,14.76,14.85,14.94
42,38,0,501,508,7,12.31,13.49,14.96
42,39,0,729,744,15,3.23,8.21,14.21
42,40,0,585,593,8,11.11,12.39,14.23
42,40,1,783,794,11,10.83,12.21,14.48
42,40,2,912,928,16,4.12,8.5,13.93
42,43,0,525,535,10,3.67,8.46,14.5
42,43,1,738,741,3,13.13,13.66,14.34
42,43,2,847,854,7,5.84,9.31,13.45
42,43,3,952,961,9,7.4,10.39,14.81
42,44,0,465,480,15,1.46,7.89,14.77
43,30,0,1020,1030,10,5.76,8.88,13.9
43,31,0,936,946,10,0.61,7.54,13.96
43,32,0,813,820,7,8.17,10.56,13.75
43,32,1,947,984,37,1.9,7.84,14.93
43,33,0,471,477,6,6.99,10.28,14.83
43,34,0,488,495,7,7.67,10.6,14.34
43,35,0,589,594,5,10.04,11.8,14.17
43,35,1,1010,1013,3,12.87,13.57,14.56
43,37,0,579,614,35,0.47,7.8,14.01
43,38,0,492,493,1,14.74,14.84,14.94
43,38,1,861,866,5,10.56,12.18,14.28
43,39,0,736,745,9,5.97,9.62,14.69
43,40,0,438,448,10,7.17,9.91,13.66
43,40,1,707,716,9,6.54,9.8,14.46
43,41,0,942,945,3,14.03,14.28,14.55
43,42,0,525,535,10,3.67,8.46,14.5
43,42,1,738,741,3,13.13,13.66,14.34
43,42,2,847,854,7,5.84,9.31,13.45
43,42,3,952,961,9,7.4,10.39,14.81
43,188,0,804,807,3,12.02,12.76,13.7
43,309,0,795,801,6,11.14,12.74,14.86
44,30,0,980,998,18,2.43,7.29,14.14
44,31,0,615,621,6,11.1,12.37,13.93
44,31,1,753,788,35,1.73,7.62,14.12
44,33,0,675,688,13,1.89,7.94,14.48
44,33,1,954,989,35,3.15,8.17,14.73
44,34,0,677,694,17,2.24,7.93,14.84
44,34,1,944,954,10,5.64,9.36,14.09
44,36,0,639,653,14,1.01,7.68,14.59
44,36,1,928,942,14,3.45,8.3,14.41
44,37,0,698,708,10,3.94,8.41,14.09
44,37,1,886,909,23,6.25,9.71,14.99
44,37,2,921,932,11,0.78,7.31,13.86
44,38,0,546,556,10,8.65,11.1,14.76
44,38,1,560,574,14,13.02,13.71,14.97
44,38,2,905,916,11,0.95,7.94,14.96
44,39,0,782,795,13,9.39,11.47,14.68
44,39,1,882,895,13,3.27,8.38,14.79
44,41,0,756,774,18,6.75,11.13,14.74
44,42,0,465,480,15,1.46,7.89,14.77
45,46,0,551,563,12,0.94,7.64,14.78
45,46,1,821,830,9,8.67,10.99,14.47
45,47,0,532,541,9,4.49,8.92,14.74
45,47,1,668,670,2,14.58,14.78,14.95
45,47,2,762,776,14,12.83,13.65,14.99
45,47,3,785,793,8,9.79,11.41,13.67
45,48,0,693,713,20,9.39,11.54,14.91
45,49,0,787,794,7,9.08,11.48,14.94
45,49,1,907,914,7,7.44,10.16,13.8
45,50,0,566,570,4,11.51,12.76,14.75
45,50,1,767,800,33,4.28,9.62,14.51
45,51,0,532,541,9,6.36,9.71,14.01
45,51,1,736,741,5,10.43,11.86,13.94
45,52,0,713,722,9,3.27,8.71,14.91
45,52,1,915,924,9,2.41,7.89,14.12
45,53,0,764,774,10,1.94,7.79,14.75
45,54,0,450,463,13,3.05,7.82,13.39
45,54,1,836,843,7,4.49,8.76,14.04
45,55,0,791,797,6,10.79,12.15,13.8
45,55,1,889,896,7,5.43,9.25,13.78
45,56,0,1019,1028,9,11.95,12.92,14.4
45,57,0,451,460,9,3.92,8.67,14.44
45,57,1,637,641,4,11.48,12.62,13.99
45,58,0,559,566,7,5.12,9.58,14.64
45,58,1,732,740,8,0.81,7.19,13.58
45,58,2,905,911,6,6.58,9.94,14.09
45,58,3,1017,1023,6,11.73,12.65,13.8
45,59,0,929,935,6,5.53,8.65,12.04
45,59,1,1014,1021,7,3.84,8.13,12.9
46,45,0,551,563,12,0.94,7.64,14.78
46,45,1,821,830,9,8.67,10.99,14.47
46,47,0,685,700,15,4.41,8.6,14.16
46,48,0,862,862,0,13.29,13.29,13.29
46,49,0,684,697,13,1.11,7.97,14.36
46,49,1,840,856,16,5.83,9.74,14.91
46,50,0,488,497,9,9.66,11.32,13.7
46,51,0,456,463,7,10.27,11.88,14.19
46,52,0,987,998,11,6.25,9.77,14.53
46,54,0,664,672,8,6.93,9.93,14.57
46,54,1,1001,1009,8,7.21,10.15,14.38
46,56,0,547,554,7,10.11,11.72,13.9
46,56,1,650,658,8,6.54,9.78,14.61
46,57,0,871,878,7,8.43,10.91,14.83
46,58,0,565,566,1,14.9,14.92,14.93
46,59,0,542,551,9,6.25,9.93,14.79
46,59,1,673,687,14,10.73,12.15,14.5
46,59,2,946,955,9,4.79,9.04,14.73
47,45,0,532,541,9,4.49,8.92,14.74
47,45,1,668,670,2,14.58,14.78,14.95
47,45,2,762,776,14,12.83,13.65,14.99
47,45,3,785,793,8,9.79,11.41,13.67
47,46,0,685,700,15,4.41,8.6,14.16
47,49,0,685,727,42,7.04,9.43,14.78
47,49,1,793,810,17,0.83,8.42,14.77
47,49,2,973,991,18,3.49,9.14,14.88
47,50,0,768,803,35,6.2,9.63,14.75
47,50,1,810,837,27,2.68,9.56,14.99
47,51,0,527,544,17,1.96,7.54,13.74
47,51,1,718,730,12,2.27,7.96,14.83
47,51,2,911,925,14,8.49,10.76,14.1
47,53,0,649,662,13,1.38,7.7,14.89
47,53,1,757,770,13,5.77,9.26,13.98
47,55,0,510,524,14,2.92,8.08,13.97
47,55,1,944,947,3,14.13,14.38,14.69
47,57,0,483,487,4,13.69,14.07,14.57
47,57,1,556,562,6,13.91,14.32,14.99
47,57,2,725,734,9,8.14,10.96,14.69
47,57,3,911,921,10,11.86,13,14.74
47,58,0,479,489,10,0.77,7.91,14.71
47,58,1,827,847,20,8,10.72,14.59
47,58,2,957,964,7,9.9,11.78,14.64
47,59,0,522,533,11,2.56,8.1,14.58
47,59,1,872,877,5,13.55,14.14,14.89
47,59,2,891,908,17,6.44,9.67,14.22
48,17,0,723,729,6,12.36,13.33,14.74
48,20,0,851,853,2,13.37,14.08,14.89
48,22,0,738,750,12,11.08,12.48,14.69
48,22,1,825,839,14,9.29,11.22,14.15
48,24,0,722,737,15,6.74,9.83,14.43
48,24,1,804,822,18,2.49,8.09,14.83
48,26,0,739,749,10,1.77,7.84,13.89
48,45,0,693,713,20,9.39,11.57,14.91
48,46,0,862,862,0,13.29,13.29,13.29
48,49,0,443,456,13,7.42,9.88,13.75
48,49,1,571,581,10,3,8.06,13.54
48,49,2,947,956,9,1.24,7.79,14.36
48,50,0,864,880,16,7.55,10.85,14.89
48,50,1,999,1011,12,11.06,12.56,14.85
48,50,2,1018,1025,7,12.68,13.34,14.35
48,51,0,991,1025,34,1.93,8.69,14.89
48,52,0,946,953,7,7.22,10.08,13.81
48,53,0,606,626,20,8.32,10.84,14.72
48,53,1,630,643,13,11.52,12.84,14.89
48,53,2,1018,1029,11,5.94,9.27,14.72
48,55,0,506,516,10,8.36,11.2,14.93
48,57,0,862,862,0,9.92,9.92,9.92
48,57,1,884,895,11,11.12,12.6,14.88
48,58,0,934,944,10,5.14,8.29,13.37
48,59,0,516,522,6,13.2,13.92,14.84
48,145,0,843,853,10,11.53,12.66,14.73
48,172,0,797,803,6,12.83,13.63,14.99
49,17,0,650,660,10,4.74,9.16,14.38
49,45,0,787,794,7,9.08,11.48,14.94
49,45,1,907,914,7,7.44,10.16,13.8
49,46,0,684,697,13,1.11,7.97,14.36
49,46,1,840,856,16,5.83,9.74,14.91
49,47,0,685,727,42,7.04,9.43,14.78
49,47,1,793,810,17,0.83,8.45,14.77
49,47,2,973,991,18,3.49,8.8,14.88
49,48,0,443,456,13,7.42,9.76,13.75
49,48,1,571,581,10,3,8.06,13.54
49,48,2,947,956,9,1.24,7.79,14.36
49,50,0,488,519,31,1.16,7.71,14.67
49,50,1,789,803,14,12.31,13.31,14.83
49,51,0,481,490,9,4.52,9.08,14.65
49,51,1,714,724,10,2.75,7.96,13.56
49,52,0,943,977,34,6.01,9.57,14.79
49,53,0,459,492,33,1.53,8.4,14.57
49,53,1,511,518,7,9.94,12.01,14.92
49,53,2,747,758,11,7.1,10.34,14.74
49,54,0,990,1005,15,5.17,9.34,14.83
49,55,0,772,788,16,3.53,8.98,14.87
49,56,0,540,547,7,8.77,10.95,14.2
49,56,1,1035,1046,11,12.17,13.15,14.93
49,57,0,720,729,9,1.8,7.81,14.75
49,58,0,813,823,10,2.76,8.2,14.09
49,59,0,684,684,0,11.96,11.96,11.96
49,59,1,1068,1076,8,5.11,9.83,14.6
50,45,0,566,570,4,11.51,12.76,14.75
50,45,1,767,800,33,4.28,9.62,14.51
50,46,0,488,497,9,9.66,11.32,13.7
50,47,0,768,803,35,6.2,9.63,14.75
50,47,1,810,837,27,2.68,9.67,14.99
50,48,0,864,880,16,7.55,10.85,14.89
50,48,1,999,1011,12,11.06,12.54,14.85
50,48,2,1018,1025,7,12.68,13.34,14.35
50,48,3,1040,1053,13,14.02,14.32,14.82
50,49,0,488,519,31,1.16,7.79,14.67
50,49,1,789,803,14,12.31,13.27,14.83
50,51,0,479,486,7,11.23,12.64,14.86
50,51,1,994,1020,26,8.83,11.44,14.84
50,53,0,512,523,11,0.58,7.47,14.48
50,53,1,528,540,12,14.74,14.83,14.99
50,53,2,555,563,8,9.17,11.66,14.78
50,53,3,762,770,8,10.62,12.21,14.6
50,53,4,1026,1026,0,15,15,15
50,55,0,732,758,26,2.18,7.76,14.27
50,55,1,791,796,5,13.1,13.65,14.46
50,57,0,1050,1053,3,7.12,10.45,13.8
50,58,0,538,545,7,10.18,11.73,13.79
50,58,1,829,834,5,12.67,13.45,14.68
50,145,0,608,608,0,14.57,14.57,14.57
50,145,1,612,658,46,5,9.07,14.93
51,45,0,532,541,9,6.36,9.71,14.01
51,45,1,736,741,5,10.43,11.86,13.94
51,46,0,432,452,20,7.94,9.79,14.41
51,46,1,456,463,7,10.27,11.88,14.19
51,47,0,527,544,17,1.96,7.54,13.74
51,47,1,718,730,12,2.27,7.96,14.83
51,47,2,911,925,14,8.49,10.76,14.1
51,48,0,991,1025,34,1.93,8.51,14.18
51,49,0,481,490,9,4.52,9.08,14.65
51,49,1,714,724,10,2.75,7.96,13.56
51,50,0,479,486,7,11.23,12.64,14.86
51,50,1,994,1020,26,8.83,11.55,14.84
51,52,0,498,510,12,3.54,8.29,14.07
51,52,1,775,788,13,2.86,7.68,13.62
51,53,0,485,494,9,8.23,10.95,14.99
51,53,1,591,598,7,7.97,10.55,13.94
51,53,2,1017,1023,6,10.05,11.83,14.58
51,54,0,756,768,12,5.35,9.14,14.35
51,55,0,523,527,4,11.98,12.72,13.52
51,57,0,545,554,9,1.43,7.92,14.55
51,57,1,667,679,12,2.24,7.91,13.73
51,57,2,792,800,8,2.99,7.88,13.37
51,57,3,915,923,8,4.36,8.62,13.56
51,58,0,727,737,10,11.67,12.83,14.85
51,59,0,528,534,6,10.55,12.23,14.26
52,45,0,713,722,9,3.27,8.71,14.91
52,45,1,915,924,9,2.41,7.89,14.12
52,46,0,987,998,11,6.25,9.77,14.53
52,47,0,438,452,14,11.28,12.55,14.5
52,48,0,946,953,7,7.22,10.08,13.81
52,49,0,943,977,34,6.01,9.63,14.79
52,51,0,498,510,12,3.54,8.29,14.07
52,51,1,775,788,13,2.86,7.91,13.62
52,53,0,821,828,7,8.94,10.99,13.64
52,54,0,476,478,2,14.47,14.66,14.87
52,54,1,674,683,9,7.32,10.48,14.71
52,55,0,692,699,7,11.11,12.61,14.84
52,55,1,1032,1052,20,7.07,9.52,14.83
52,56,0,573,575,2,14.04,14.25,14.44
52,56,1,661,669,8,6.19,9.53,14.24
52,58,0,1032,1045,13,4.93,9,14.53
52,59,0,802,817,15,1.27,7.22,14.85
53,45,0,764,774,10,1.94,7.79,14.75
53,47,0,649,662,13,1.38,7.7,14.89
53,47,1,757,770,13,5.77,9.26,13.98
53,48,0,606,626,20,8.32,10.84,14.72
53,48,1,630,643,13,11.52,12.84,14.89
53,48,2,1018,1030,12,5.94,9.59,14.72
53,49,0,469,492,23,5.12,9.34,14.57
53,49,1,511,518,7,9.94,12.01,14.92
53,49,2,747,758,11,7.1,10.34,14.74
53,50,0,512,523,11,0.58,7.47,14.48
53,50,1,528,540,12,14.74,14.83,14.99
53,50,2,555,563,8,9.17,11.66,14.78
53,50,3,762,770,8,10.62,12.21,14.6
53,50,4,1026,1026,0,15,15,15
53,51,0,485,494,9,8.23,10.95,14.99
53,51,1,591,598,7,7.97,10.55,13.94
53,51,2,1017,1023,6,10.05,11.83,14.58
53,52,0,821,828,7,8.94,10.99,13.64
53,55,0,855,863,8,9.22,11.45,14.37
53,57,0,826,832,6,9.42,11.69,14.79
53,57,1,926,934,8,8.92,11.28,14.79
53,58,0,538,550,12,3.63,8.46,14.33
53,58,1,700,708,8,5.33,9.12,13.89
53,58,2,790,797,7,1.06,7.56,14.09
53,59,0,723,745,22,2.06,7.93,14.77
54,45,0,836,843,7,4.49,8.76,14.04
54,46,0,664,672,8,6.93,9.93,14.57
54,46,1,1001,1009,8,7.21,10.15,14.38
54,49,0,990,1005,15,5.17,9.34,14.83
54,51,0,756,768,12,5.35,9.14,14.35
54,52,0,476,478,2,14.47,14.66,14.87
54,52,1,674,683,9,7.32,10.48,14.71
54,55,0,616,647,31,3.74,8.42,14.48
54,55,1,956,964,8,6.63,10.12,14.28
54,56,0,485,508,23,4.5,8.9,14.81
54,56,1,691,695,4,12.56,13.33,14.43
54,57,0,608,610,2,13.93,14.21,14.49
54,58,0,507,536,29,2.01,7.39,14.64
54,58,1,745,751,6,9.05,11.26,13.84
54,58,2,856,863,7,5.77,9.26,13.43
54,58,3,967,975,8,0.93,7.87,14.04
54,59,0,565,573,8,7.58,10.48,14.49
54,59,1,849,859,10,11,12.39,14.81
55,45,0,791,797,6,10.79,12.15,13.8
55,45,1,889,896,7,5.43,9.25,13.78
55,47,0,510,524,14,2.92,8.08,13.97
55,47,1,944,947,3,14.13,14.38,14.69
55,48,0,506,516,10,8.36,11.2,14.93
55,49,0,772,788,16,3.53,9.14,14.87
55,50,0,732,758,26,2.18,7.76,14.27
55,50,1,791,796,5,13.1,13.65,14.46
55,51,0,523,527,4,11.98,12.72,13.52
55,52,0,692,699,7,11.11,12.61,14.84
55,52,1,1032,1041,9,9.24,11.02,14.83
55,53,0,855,863,8,9.22,11.45,14.37
55,54,0,616,647,31,3.74,8.42,14.48
55,54,1,956,964,8,6.63,10.12,14.28
55,56,0,992,1007,15,4.55,8.7,13.97
55,57,0,1012,1029,17,13.16,13.75,14.73
55,58,0,636,641,5,8.97,10.64,12.63
55,58,1,1035,1041,6,13.78,14.28,14.83
55,59,0,836,844,8,2.59,8.02,14.92
55,59,1,1006,1014,8,5.05,9.42,14.31
56,33,0,760,773,13,2.45,7.75,13.96
56,45,0,1019,1028,9,11.95,12.92,14.4
56,46,0,454,454,0,14.14,14.14,14.14
56,46,1,547,554,7,10.11,11.72,13.9
56,46,2,650,658,8,6.54,9.78,14.61
56,49,0,540,547,7,8.77,10.95,14.2
56,49,1,1035,1046,11,12.17,13.15,14.93
56,52,0,573,575,2,14.04,14.25,14.44
56,52,1,661,669,8,6.19,9.53,14.24
56,54,0,485,508,23,4.5,8.9,14.81
56,54,1,691,695,4,12.56,13.33,14.43
56,55,0,992,1007,15,4.55,8.7,13.97
56,57,0,584,603,19,2.87,7.98,14.11
56,58,0,504,511,7,11.88,12.95,14.43
56,58,1,623,627,4,12.68,13.57,14.46
56,58,2,1005,1018,13,0.86,7.45,14.24
56,59,0,549,557,8,8.65,11.19,14.48
56,59,1,635,646,11,6.43,9.57,13.79
56,59,2,1012,1019,7,12.46,13.17,14.17
56,77,0,846,855,9,4.54,8.59,13.74
56,77,1,945,954,9,7.42,10.56,14.98
56,227,0,769,769,0,7.92,7.92,7.92
56,286,0,935,943,8,7.88,10.42,13.87
56,287,0,824,824,0,11.92,11.92,11.92
56,288,0,836,849,13,10.91,12.27,14.38
56,290,0,919,923,4,10.64,11.98,14
56,291,0,831,834,3,14.39,14.61,14.93
56,292,0,954,955,1,13.95,14.2,14.44
56,294,0,945,954,9,4.17,8.48,14.01
56,295,0,938,951,13,2.69,7.75,13.58
57,45,0,451,460,9,3.92,8.67,14.44
57,45,1,637,641,4,11.48,12.62,13.99
57,46,0,421,425,4,12.66,13.29,14.38
57,46,1,871,878,7,8.43,10.91,14.83
57,47,0,483,487,4,13.69,14.07,14.57
57,47,1,556,562,6,13.91,14.32,14.99
57,47,2,725,734,9,8.14,10.96,14.69
57,47,3,911,921,10,11.86,13,14.74
57,48,0,862,862,0,9.92,9.92,9.92
57,48,1,884,895,11,11.12,12.6,14.88
57,48,2,1057,1072,15,4.08,8.63,14.78
57,49,0,720,729,9,1.8,7.81,14.75
57,50,0,1050,1065,15,0.3,7.39,14.48
57,51,0,421,431,10,0.95,6.24,13.89
57,51,1,545,554,9,1.43,7.92,14.55
57,51,2,667,679,12,1.31,7.78,13.73
57,51,3,792,800,8,2.99,7.88,13.37
57,51,4,915,923,8,4.36,8.62,13.56
57,53,0,826,832,6,9.42,11.69,14.79
57,53,1,926,934,8,8.92,11.28,14.79
57,54,0,445,460,15,2.16,7.63,13.71
57,54,1,608,610,2,13.93,14.21,14.49
57,55,0,1012,1029,17,13.16,13.75,14.73
57,56,0,584,603,19,2.87,7.91,14.11
57,58,0,476,484,8,8.41,10.88,14.17
57,58,1,975,985,10,0.26,7.63,14.19
57,58,2,1061,1073,12,12.4,13.33,14.49
57,59,0,461,477,16,2.98,8.36,14.3
57,59,1,904,912,8,4.91,9.02,14.77
57,59,2,1001,1009,8,2.54,7.75,14.03
58,45,0,559,566,7,5.12,9.58,14.64
58,45,1,732,740,8,0.81,7.19,13.58
58,45,2,905,911,6,6.58,9.94,14.09
58,45,3,1017,1023,6,11.73,12.65,13.8
58,46,0,565,566,1,14.9,14.92,14.93
58,47,0,479,489,10,0.77,7.91,14.71
58,47,1,827,847,20,8,10.67,14.59
58,47,2,957,964,7,9.9,11.78,14.64
58,48,0,934,944,10,5.14,8.49,13.37
58,48,1,1050,1063,13,5.92,9.54,14.3
58,49,0,813,823,10,2.76,8.2,14.09
58,50,0,538,545,7,10.18,11.73,13.79
58,50,1,829,834,5,12.67,13.45,14.68
58,51,0,727,737,10,11.67,12.83,14.85
58,52,0,1032,1045,13,4.93,9,14.53
58,53,0,538,550,12,3.63,8.46,14.33
58,53,1,700,708,8,5.33,9.12,13.89
58,53,2,790,797,7,1.06,7.56,14.09
58,54,0,507,536,29,2.01,7.45,14.64
58,54,1,745,751,6,9.05,11.26,13.84
58,54,2,856,863,7,5.77,9.26,13.43
58,54,3,967,975,8,0.93,7.87,14.04
58,55,0,636,641,5,8.97,10.64,12.63
58,55,1,1035,1050,15,11.05,13.15,14.83
58,56,0,504,511,7,11.88,12.95,14.43
58,56,1,623,627,4,12.68,13.57,14.46
58,56,2,1005,1018,13,0.86,7.45,14.24
58,57,0,476,484,8,8.41,10.88,14.17
58,57,1,975,985,10,0.26,7.63,14.19
58,57,2,1061,1065,4,13.21,13.7,14.2
58,59,0,859,865,6,9.35,11.77,14.99
58,59,1,1012,1018,6,7.63,10.39,14.53
59,45,0,929,935,6,5.53,8.65,12.04
59,45,1,1014,1021,7,3.84,8.13,12.9
59,46,0,542,551,9,6.25,9.93,14.79
59,46,1,673,687,14,10.73,12.15,14.5
59,46,2,946,955,9,4.79,9.04,14.73
59,47,0,522,533,11,2.56,8.1,14.58
59,47,1,872,877,5,13.55,14.14,14.89
59,47,2,891,908,17,6.44,9.67,14.22
59,48,0,516,522,6,13.2,13.92,14.84
59,49,0,684,684,0,11.96,11.96,11.96
59,51,0,528,534,6,10.55,12.23,14.26
59,52,0,802,817,15,1.27,7.01,14.85
59,53,0,723,745,22,2.08,7.95,14.77
59,54,0,565,573,8,7.58,10.48,14.49
59,54,1,849,859,10,11,12.39,14.81
59,55,0,836,844,8,2.59,8.02,14.92
59,55,1,1006,1014,8,5.05,9.42,14.31
59,56,0,549,557,8,8.65,11.19,14.48
59,56,1,635,646,11,6.43,9.57,13.79
59,56,2,1012,1019,7,12.46,13.17,14.17
59,57,0,476,477,1,12.96,13.63,14.3
59,57,1,904,912,8,4.91,9.02,14.77
59,57,2,1001,1009,8,2.54,7.75,14.03
59,58,0,859,865,6,9.35,11.77,14.99
59,58,1,1012,1018,6,7.63,10.39,14.53
60,61,0,971,976,5,13.01,13.48,14.09
60,62,0,1027,1047,20,1.36,6.56,14.64
60,63,0,562,571,9,8.52,11.3,14.97
60,63,1,872,877,5,12.53,13.29,14.36
60,64,0,793,799,6,10.75,12.31,14.31
60,64,1,917,925,8,2.48,7.72,14.23
60,64,2,928,955,27,1.41,7.26,14.23
60,64,3,1044,1047,3,7.62,10.87,14.51
60,66,0,656,670,14,3.91,8.48,14.08
60,67,0,640,688,48,4.53,8.75,14.57
60,67,1,996,1014,18,1.45,7.86,14.61
60,68,0,555,565,10,6.18,9.73,14.69
60,70,0,983,995,12,4.53,8.78,14.71
60,71,0,514,522,8,6.54,9.81,13.79
60,71,1,728,736,8,8.96,11.04,14.14
60,71,2,1023,1047,24,6.7,10,14.96
60,72,0,852,866,14,11.39,12.63,14.81
60,72,1,878,887,9,6.76,9.47,13
60,72,2,991,993,2,14.33,14.47,14.58
60,73,0,761,776,15,8.88,11.35,14.67
61,60,0,971,976,5,13.01,13.48,14.09
61,63,0,518,522,4,12.46,13.36,14.64
61,63,1,604,611,7,7.32,10.17,13.84
61,63,2,680,691,11,10.81,12.31,14.54
61,63,3,789,796,7,7.01,9.9,13.45
61,64,0,604,610,6,6.76,10.13,14.32
61,64,1,696,700,4,12.64,13.34,14.41
61,64,2,783,790,7,8.25,10.65,14.12
61,64,3,872,880,8,6.29,9.73,14.65
61,64,4,960,969,9,1.93,8.03,14.81
61,65,0,650,658,8,7.3,10.44,14.08
61,66,0,579,588,9,0.94,7.17,13.4
61,66,1,726,749,23,4.59,8.59,14.86
61,69,0,771,778,7,4.74,8.77,13.59
61,69,1,852,857,5,11.1,12.6,14.54
61,69,2,1016,1021,5,9.34,10.93,12.93
61,70,0,977,979,2,13.51,13.8,13.95
61,72,0,928,935,7,1.64,6.94,12.26
61,73,0,632,641,9,9.99,11.57,13.79
61,73,1,662,684,22,7.82,10.62,14.82
61,74,0,863,869,6,6.17,9.4,12.96
62,63,0,577,580,3,14.11,14.31,14.53
62,64,0,736,737,1,14.86,14.89,14.92
62,64,1,861,871,10,1.15,7.86,14.37
62,65,0,840,860,20,11.44,12.72,14.9
62,65,1,909,923,14,1.66,7.61,14.36
62,66,0,883,889,6,13.62,14.04,14.57
62,68,0,876,888,12,4.8,9.05,14.64
62,69,0,612,623,11,1,7.7,14.46
62,69,1,946,956,10,7.42,10.5,14.67
62,69,2,959,972,13,12.32,13.28,14.84
62,70,0,633,645,12,1.83,7.75,13.98
62,71,0,1021,1024,3,8.15,11.43,14.71
62,72,0,611,620,9,5.43,9.16,14.02
62,72,1,830,839,9,3.25,7.88,13.38
62,73,0,903,914,11,11.25,12.57,14.64
62,74,0,850,859,9,10.6,12.07,14.44
63,60,0,562,571,9,8.52,11.3,14.97
63,60,1,872,877,5,12.53,13.29,14.36
63,61,0,518,522,4,12.46,13.36,14.64
63,61,1,604,611,7,7.32,10.17,13.84
63,61,2,680,691,11,10.81,12.31,14.54
63,61,3,789,796,7,7.01,9.9,13.45
63,62,0,577,580,3,14.11,14.31,14.53
63,64,0,522,522,0,14.95,14.95,14.95
63,64,1,607,621,14,2.18,9.38,14.44
63,64,2,702,708,6,8.07,10.3,13.28
63,65,0,480,487,7,6.83,9.61,13.06
63,65,1,739,746,7,8.89,11.27,14.29
63,66,0,492,501,9,6.95,10.16,14.82
63,67,0,511,524,13,12.02,13.11,14.86
63,68,0,526,531,5,11.63,12.74,14.52
63,68,1,711,713,2,14.09,14.32,14.55
63,68,2,985,987,2,14.31,14.52,14.86
63,70,0,477,479,2,10.65,12.67,14.83
63,70,1,654,662,8,1.37,7.24,13.27
63,70,2,933,957,24,6.49,9.6,14.19
63,72,0,531,545,14,1.63,8.47,14.4
63,72,1,755,761,6,9.05,10.94,13.15
63,73,0,683,727,44,0.86,7.54,14.72
63,74,0,926,931,5,11.49,12.75,14.77
63,74,1,935,942,7,13.62,14.07,14.7
64,60,0,793,799,6,10.75,12.31,14.31
64,60,1,917,955,38,1.41,7.54,14.23
64,60,2,1044,1055,11,6.27,9.44,14.51
64,61,0,604,610,6,6.76,10.13,14.32
64,61,1,696,700,4,12.64,13.34,14.41
64,61,2,783,790,7,8.25,10.65,14.12
64,61,3,872,880,8,6.29,9.73,14.65
64,61,4,960,969,9,1.93,8.03,14.81
64,62,0,736,737,1,14.86,14.89,14.92
64,62,1,861,871,10,1.15,7.86,14.37
64,62,2,1046,1059,13,3.12,7.86,13.4
64,63,0,522,522,0,14.95,14.95,14.95
64,63,1,607,621,14,2.18,9.42,14.44
64,63,2,702,708,6,8.07,10.3,13.28
64,65,0,857,864,7,3.66,7.86,12.72
64,68,0,465,499,34,0.76,9.02,14.45
64,68,1,595,596,1,14.81,14.82,14.82
64,68,2,718,723,5,11.36,12.72,14.8
64,68,3,826,836,10,1.32,7.52,13.83
64,69,0,490,496,6,7.58,10.29,14.5
64,69,1,661,678,17,4.47,8.56,13.93
64,70,0,551,561,10,0.4,7.32,13.75
64,71,0,572,578,6,10.69,12.19,14.13
64,71,1,666,672,6,5.82,9.29,13.15
64,71,2,1048,1061,13,3.98,8.35,13.86
64,72,0,647,660,13,1.85,7.92,14.28
64,73,0,702,708,6,8.47,10.97,14.76
64,73,1,973,980,7,1.76,7.63,14.12
64,74,0,534,539,5,9.51,11.41,14.24
64,74,1,972,983,11,2.8,8.15,14.64
65,61,0,650,658,8,7.3,10.12,14.08
65,62,0,840,860,20,11.44,12.72,14.9
65,62,1,909,923,14,1.66,7.61,14.36
65,63,0,480,487,7,6.83,9.61,13.06
65,63,1,739,746,7,8.89,11.27,14.29
65,64,0,857,864,7,3.66,7.86,12.72
65,66,0,869,878,9,8.85,11.21,14.65
65,68,0,661,671,10,2.66,8.05,14.65
65,68,1,868,874,6,11.55,12.91,14.96
65,69,0,751,753,2,14.45,14.55,14.64
65,70,0,595,617,22,1.63,7.85,14.3
65,70,1,810,815,5,11.07,12.06,13.27
65,71,0,762,782,20,1.03,7.81,14.98
65,71,1,972,977,5,11.41,12.51,14.01
65,72,0,708,717,9,1.38,7.98,14.64
65,74,0,691,699,8,1.52,7.33,13.28
65,74,1,741,757,16,12.89,13.6,14.91
65,74,2,843,849,6,13.77,14.24,14.89
66,3,0,1011,1027,16,6.81,10.13,14.71
66,60,0,656,670,14,3.91,8.48,14.08
66,61,0,579,588,9,0.94,7.17,13.4
66,61,1,726,749,23,4.59,8.63,14.86
66,62,0,883,889,6,13.62,14.04,14.57
66,63,0,492,501,9,6.95,10.16,14.82
66,65,0,869,878,9,8.85,11.21,14.65
66,67,0,467,481,14,10.5,12.08,14.57
66,67,1,657,674,17,7.72,10.44,14.77
66,67,2,786,841,55,5.54,9.41,14.98
66,67,3,847,866,19,4.94,9.02,14.51
66,68,0,797,823,26,4.99,8.93,14.32
66,69,0,640,654,14,0.44,7.35,14.06
66,69,1,789,801,12,3.7,8.41,14.27
66,70,0,766,777,11,4.44,8.45,13.35
66,71,0,909,925,16,4.45,8.04,14.5
66,72,0,468,480,12,4.15,8.97,14.7
66,72,1,636,642,6,12.6,13.41,14.67
66,72,2,788,797,9,5.9,9.3,13.69
66,73,0,797,804,7,9.66,11.52,14.52
66,74,0,622,632,10,2.25,7.78,13.48
66,301,0,961,971,10,8.31,11.47,14.63
66,307,0,966,974,8,10.44,11.85,13.77
66,307,1,1005,1028,23,8.01,10.58,14.69
67,60,0,640,688,48,4.53,8.72,14.57
67,60,1,996,1014,18,1.45,7.86,14.61
67,63,0,511,524,13,12.02,13.11,14.86
67,66,0,467,481,14,10.5,12.08,14.57
67,66,1,657,674,17,7.72,10.44,14.77
67,66,2,786,841,55,5.54,9.41,14.98
67,66,3,847,866,19,4.94,9.02,14.51
67,68,0,524,537,13,7.49,10.57,14.83
67,68,1,800,818,18,9.35,11.47,14.68
67,69,0,522,533,11,6.07,9.24,13.36
67,69,1,788,796,8,11.91,13.03,14.91
67,69,2,920,932,12,4.26,8.58,14.35
67,70,0,755,768,13,7.97,10.58,14.56
67,72,0,474,490,16,4.61,8.75,14.14
67,72,1,782,794,12,0.55,7.85,14.52
67,73,0,792,803,11,6.29,9.77,14.66
67,73,1,955,959,4,14.71,14.82,14.95
68,60,0,555,565,10,6.18,9.73,14.69
68,62,0,876,888,12,4.8,9.05,14.64
68,63,0,526,531,5,11.63,12.74,14.52
68,63,1,711,713,2,14.09,14.32,14.55
68,63,2,985,987,2,14.31,14.52,14.86
68,64,0,480,499,19,8.66,10.43,14.45
68,64,1,595,596,1,14.81,14.82,14.82
68,64,2,718,723,5,11.36,12.72,14.8
68,64,3,826,836,10,1.32,7.52,13.83
68,65,0,661,671,10,2.66,8.05,14.65
68,65,1,868,874,6,11.55,12.91,14.96
68,66,0,797,823,26,4.99,8.93,14.32
68,67,0,524,537,13,7.49,10.57,14.83
68,67,1,800,818,18,9.35,11.47,14.68
68,69,0,491,500,9,2.67,7.96,13.92
68,69,1,528,545,17,6.87,10.12,14.81
68,69,2,787,797,10,12.35,13.24,14.57
68,72,0,493,501,8,10.18,12.16,14.82
68,72,1,522,531,9,10.69,12.41,14.94
68,72,2,1003,1019,16,10.38,11.99,14.54
68,73,0,619,621,2,14.3,14.54,14.68
68,73,1,798,807,9,2.37,7.86,13.75
68,74,0,762,770,8,9.62,11.46,14.35
69,60,0,1075,1077,2,13.05,13.77,14.55
69,61,0,435,439,4,14.31,14.54,14.98
69,61,1,771,778,7,4.74,8.77,13.59
69,61,2,852,857,5,11.1,12.6,14.54
69,61,3,1016,1021,5,9.34,10.93,12.93
69,61,4,1054,1069,15,2.85,8.14,14.57
69,62,0,612,623,11,1,7.7,14.46
69,62,1,946,956,10,7.42,10.5,14.67
69,62,2,959,972,13,12.32,13.28,14.84
69,64,0,490,496,6,7.58,10.29,14.5
69,64,1,661,678,17,4.47,8.56,13.93
69,65,0,751,753,2,14.45,14.55,14.64
69,66,0,640,654,14,0.44,7.35,14.06
69,66,1,789,801,12,3.7,8.41,14.27
69,67,0,522,533,11,6.07,9.24,13.36
69,67,1,788,796,8,11.91,13.03,14.91
69,67,2,920,932,12,4.26,8.58,14.35
69,68,0,491,500,9,2.67,7.96,13.92
69,68,1,528,545,17,6.87,10.12,14.81
69,68,2,787,797,10,12.35,13.24,14.57
69,70,0,572,585,13,5.77,10.29,14.09
69,70,1,895,897,2,14.44,14.63,14.87
69,71,0,469,479,10,2.93,8.86,14.29
69,71,1,601,607,6,13.14,13.74,14.67
69,71,2,664,672,8,5.23,9.19,14.25
69,71,3,859,864,5,12.37,13.39,14.69
69,72,0,488,519,31,4.24,8.75,14.85
69,72,1,576,633,57,1.53,7.71,14.93
69,72,2,788,809,21,4.47,10.94,14.73
69,74,0,893,900,7,7.01,10.06,14.46
70,60,0,983,995,12,4.53,8.78,14.71
70,61,0,977,979,2,13.51,13.8,13.95
70,62,0,633,645,12,1.83,7.75,13.98
70,63,0,464,479,15,7.69,10.4,14.83
70,63,1,654,662,8,1.37,7.24,13.27
70,63,2,933,957,24,6.49,9.6,14.19
70,64,0,440,449,9,1.58,7.15,13.6
70,64,1,551,561,10,0.4,7.32,13.75
70,65,0,452,468,16,8.69,11.17,14.83
70,65,1,595,617,22,1.63,7.8,14.3
70,65,2,810,815,5,11.07,12.06,13.27
70,66,0,766,777,11,4.44,8.45,13.35
70,67,0,755,768,13,7.97,10.58,14.56
70,69,0,572,585,13,5.77,10.08,14.09
70,69,1,895,897,2,14.44,14.63,14.87
70,71,0,525,526,1,14.7,14.82,14.93
70,71,1,709,723,14,5.44,9.92,14.56
70,72,0,578,590,12,2.89,7.62,14.23
70,72,1,679,688,9,7.74,10.67,14.68
70,72,2,989,996,7,8.37,11.05,14.77
70,73,0,561,569,8,6.76,9.96,14.59
70,74,0,920,930,10,6.57,9.86,14.64
71,60,0,514,522,8,6.54,9.81,13.79
71,60,1,728,736,8,8.96,11.04,14.14
71,60,2,1023,1024,1,13.51,14.07,14.64
71,62,0,1021,1024,3,8.15,11.43,14.71
71,64,0,572,578,6,10.69,12.19,14.13
71,64,1,666,672,6,5.82,9.29,13.15
71,65,0,762,782,20,1.03,7.81,14.98
71,65,1,972,977,5,11.41,12.51,14.01
71,66,0,909,925,16,4.45,8.04,14.5
71,69,0,472,479,7,2.93,7.36,14.27
71,69,1,601,607,6,13.14,13.74,14.67
71,69,2,664,672,8,5.23,9.19,14.25
71,69,3,859,864,5,12.37,13.39,14.69
71,70,0,525,526,1,14.7,14.82,14.93
71,70,1,709,723,14,5.44,10.08,14.56
71,72,0,600,607,7,11.55,12.84,14.68
71,72,1,950,953,3,12.81,13.47,14.39
71,73,0,495,503,8,2.09,8,14.85
71,73,1,741,747,6,8.17,10.77,14.69
71,74,0,758,767,9,9.62,11.62,14.59
71,74,1,992,997,5,10.9,12.41,14.44
72,60,0,852,866,14,11.39,12.63,14.81
72,60,1,878,887,9,6.76,9.47,13
72,60,2,991,993,2,14.33,14.47,14.58
72,61,0,928,935,7,1.64,6.94,12.26
72,62,0,611,620,9,5.43,9.16,14.02
72,62,1,830,839,9,3.25,7.88,13.38
72,63,0,531,545,14,1.63,8.54,14.4
72,63,1,755,761,6,9.05,10.94,13.15
72,64,0,647,660,13,1.85,7.57,14.28
72,65,0,708,717,9,1.38,7.98,14.64
72,66,0,468,480,12,4.15,8.97,14.7
72,66,1,636,642,6,12.6,13.41,14.67
72,66,2,788,797,9,5.9,9.3,13.69
72,67,0,474,490,16,4.61,8.75,14.14
72,67,1,782,794,12,0.55,7.85,14.52
72,68,0,493,501,8,10.18,12.16,14.82
72,68,1,522,531,9,10.69,12.41,14.94
72,68,2,1003,1019,16,10.38,11.99,14.54
72,69,0,488,519,31,4.24,8.78,14.85
72,69,1,576,633,57,1.53,7.71,14.93
72,69,2,788,809,21,4.47,10.81,14.73
72,70,0,578,590,12,2.89,7.42,14.23
72,70,1,679,688,9,7.74,10.67,14.68
72,70,2,989,996,7,8.37,11.05,14.77
72,71,0,600,607,7,11.55,12.84,14.68
72,71,1,950,953,3,12.81,13.47,14.39
72,73,0,808,818,10,5.91,9.66,14.43
72,73,1,980,989,9,6.19,9.76,14.85
72,74,0,548,554,6,7.43,10.23,14.25
72,74,1,634,636,2,14.02,14.26,14.48
73,60,0,761,776,15,8.88,11.57,14.67
73,61,0,632,641,9,9.99,11.57,13.79
73,61,1,662,684,22,7.82,10.62,14.82
73,62,0,903,914,11,11.25,12.57,14.64
73,63,0,434,442,8,6.37,9.49,14.68
73,63,1,683,727,44,0.86,7.56,14.72
73,64,0,702,708,6,8.47,10.97,14.76
73,64,1,973,980,7,1.76,7.63,14.12
73,66,0,797,804,7,9.66,11.52,14.52
73,67,0,792,803,11,6.29,9.77,14.66
73,67,1,955,959,4,14.71,14.82,14.95
73,67,2,1046,1052,6,13.65,14.11,14.74
73,68,0,619,621,2,14.3,14.54,14.68
73,68,1,798,807,9,2.37,7.86,13.75
73,70,0,561,569,8,6.76,9.96,14.59
73,71,0,495,503,8,2.09,8,14.85
73,71,1,741,747,6,8.17,10.77,14.69
73,72,0,808,818,10,5.91,9.66,14.43
73,72,1,980,989,9,6.19,9.76,14.85
73,74,0,444,464,20,3.33,10.66,14.88
73,74,1,827,834,7,7.87,10.75,14.47
73,74,2,968,982,14,4.2,8.68,14.88
74,61,0,863,869,6,6.17,9.4,12.96
74,62,0,850,859,9,10.6,12.07,14.44
74,63,0,926,931,5,11.49,12.75,14.77
74,63,1,935,942,7,13.62,14.07,14.7
74,64,0,534,539,5,9.51,11.41,14.24
74,64,1,972,983,11,2.8,8.15,14.64
74,65,0,691,699,8,1.52,7.33,13.28
74,65,1,741,757,16,12.89,13.6,14.91
74,65,2,843,849,6,13.77,14.24,14.89
74,66,0,622,632,10,2.25,7.78,13.48
74,68,0,762,770,8,9.62,11.46,14.35
74,69,0,893,900,7,7.01,10.06,14.46
74,70,0,920,930,10,6.57,9.71,14.64
74,70,1,1045,1046,1,13.47,14.02,14.57
74,71,0,758,767,9,9.62,11.62,14.59
74,71,1,992,997,5,10.9,12.41,14.44
74,72,0,548,554,6,7.43,10.23,14.25
74,72,1,634,636,2,14.02,14.26,14.48
74,73,0,444,464,20,3.33,10.75,14.88
74,73,1,827,834,7,7.87,10.75,14.47
74,73,2,968,982,14,4.2,8.68,14.88
75,76,0,677,689,12,2.07,7.77,13.97
75,76,1,923,930,7,4.62,8.85,13.81
75,77,0,520,530,10,2.9,8.7,14.89
75,77,1,977,977,0,12.81,12.81,12.81
75,77,2,983,992,9,7.31,10.35,14.85
75,78,0,630,640,10,2.6,7.54,14.53
75,78,1,743,751,8,12.28,13.41,14.99
75,78,2,938,941,3,13.93,14.29,14.81
75,79,0,748,762,14,4.1,8.63,14.25
75,80,0,621,638,17,6.3,9.84,14.78
75,80,1,641,663,22,8.91,11.14,14.59
75,81,0,759,764,5,11.13,12.17,13.5
75,82,0,715,725,10,8.87,11.05,14.15
75,82,1,998,1006,8,12.06,13.25,14.96
75,83,0,611,616,5,11.08,12.22,13.86
75,83,1,795,804,9,2.47,8.3,14.51
75,83,2,888,897,9,2.24,8.08,14.32
75,84,0,730,736,6,14.14,14.38,14.72
75,84,1,1015,1022,7,9.7,11.82,14.67
75,85,0,615,628,13,4.44,8.57,13.75
75,86,0,852,858,6,10.94,12.14,13.83
75,86,1,944,949,5,13.15,13.84,14.91
75,86,2,1050,1060,10,6.73,10,14.29
75,87,0,929,932,3,14.37,14.58,14.87
75,89,0,746,760,14,4.26,8.76,14.65
75,89,1,899,903,4,13.97,14.3,14.85
76,75,0,677,689,12,2.07,7.77,13.97
76,75,1,923,930,7,4.62,8.85,13.81
76,77,0,794,798,4,7.16,9.33,13.13
76,78,0,617,618,1,14.73,14.75,14.78
76,78,1,718,728,10,2.17,7.58,13.55
76,78,2,824,829,5,9.1,11.23,14.25
76,79,0,456,464,8,1.08,6.41,13.74
76,79,1,723,727,4,13.88,14.22,14.6
76,79,2,864,874,10,1.19,7.58,14.14
76,79,3,948,969,21,2.37,7.94,14.69
76,79,4,1011,1013,2,14.57,14.73,14.93
76,80,0,788,792,4,12.32,13.02,13.73
76,81,0,667,675,8,4.46,9.11,14.68
76,81,1,968,975,7,10.94,12.4,14.44
76,83,0,534,539,5,9.47,11.01,12.92
76,84,0,490,497,7,5.7,9.42,13.88
76,84,1,875,887,12,12.04,13.1,14.98
76,84,2,894,916,22,1.8,10.66,14.88
76,85,0,470,476,6,4.71,8.54,14.11
76,85,1,724,728,4,10.72,12.01,13.38
76,86,0,600,609,9,5.83,9.2,13.48
76,87,0,513,519,6,10.5,11.97,13.77
76,87,1,632,642,10,5.57,9.19,14.34
76,87,2,848,871,23,3.17,8.34,14.67
76,87,3,925,934,9,10.9,12.26,14.37
76,88,0,514,523,9,8.61,10.9,13.99
76,88,1,947,958,11,7.62,10.54,14.6
76,89,0,962,965,3,14.73,14.81,14.89
77,56,0,846,855,9,4.54,8.59,13.74
77,56,1,945,954,9,7.42,10.56,14.98
77,75,0,520,530,10,2.9,8.7,14.89
77,75,1,977,977,0,12.81,12.81,12.81
77,75,2,983,992,9,7.31,10.35,14.85
77,76,0,794,798,4,7.16,9.33,13.13
77,78,0,532,559,27,4.26,8.91,14.67
77,79,0,638,646,8,9.86,11.69,14.16
77,81,0,590,593,3,13.84,14.25,14.87
77,82,0,1066,1074,8,12.47,13.16,14.57
77,83,0,494,507,13,1.99,7.49,13.63
77,83,1,779,787,8,8.32,10.77,14.64
77,84,0,596,607,11,4.82,8.74,13.65
77,84,1,709,713,4,13.46,13.95,14.66
77,85,0,549,559,10,1.05,7.6,14.81
77,85,1,765,767,2,14.36,14.56,14.9
77,86,0,563,571,8,1.49,7.57,14.76
77,86,1,705,709,4,14.39,14.61,14.9
77,87,0,786,793,7,9.81,11.58,13.97
77,88,0,590,594,4,13.2,13.85,14.69
77,286,0,824,827,3,7.09,10.98,13.53
77,291,0,910,928,18,1.94,7.26,13.57
77,292,0,949,955,6,0.6,6.74,14.7
77,294,0,909,919,10,2.81,7.84,13.39
77,294,1,937,955,18,1.52,6.81,14.22
77,295,0,944,955,11,5.05,8.05,13.79
77,298,0,927,932,5,11.14,12.41,14.3
77,299,0,864,871,7,11.92,12.92,14.31
78,75,0,630,641,11,2.6,7.99,14.53
78,75,1,743,751,8,12.28,13.41,14.99
78,75,2,938,941,3,13.93,14.29,14.81
78,76,0,617,618,1,14.73,14.75,14.78
78,76,1,718,728,10,2.17,7.58,13.55
78,76,2,824,829,5,9.1,11.23,14.25
78,77,0,532,559,27,4.26,8.91,14.67
78,79,0,725,746,21,3.45,8.7,14.39
78,80,0,628,637,9,2.14,8.01,14.38
78,80,1,949,958,9,1.89,8.01,14.88
78,81,0,754,757,3,13.57,14.06,14.6
78,81,1,1007,1013,6,11.12,12.84,14.9
78,82,0,579,591,12,0.51,8.04,14.79
78,82,1,767,791,24,0.25,7.47,14.28
78,82,2,978,988,10,6.72,9.93,14.84
78,83,0,701,709,8,1.64,7.8,13.79
78,84,0,765,775,10,13.26,13.79,14.59
78,84,1,778,792,14,9.14,11.36,14.68
78,84,2,999,1007,8,5.11,9.5,14.37
78,85,0,553,563,10,6.6,9.57,13.61
78,86,0,477,479,2,11.79,13.08,14.53
78,86,1,946,949,3,12.27,13.07,14.21
78,86,2,1041,1047,6,6.96,10.25,14.85
78,87,0,495,510,15,1.55,7.73,14.47
78,88,0,477,487,10,9.96,13.05,14.83
78,88,1,705,713,8,0.72,7.22,13.49
78,88,2,815,822,7,11.18,12.54,14.39
78,89,0,594,601,7,11.71,12.73,14.32
78,89,1,739,750,11,2.32,8.01,14.61
79,75,0,748,762,14,4.1,8.63,14.25
79,76,0,462,464,2,9.67,11.7,13.74
79,76,1,723,727,4,13.88,14.22,14.6
79,76,2,864,874,10,1.19,7.58,14.14
79,76,3,948,969,21,2.37,7.94,14.69
79,76,4,1011,1013,2,14.57,14.73,14.93
79,77,0,638,646,8,9.86,11.69,14.16
79,78,0,725,746,21,3.45,8.89,14.39
79,80,0,886,899,13,7.44,10.43,14.72
79,81,0,494,505,11,2.68,7.48,12.82
79,81,1,761,772,11,4.3,8.37,13.38
79,83,0,653,673,20,4.2,8.74,14.62
79,83,1,682,692,10,9.83,11.77,14.45
79,85,0,848,851,3,14.3,14.46,14.63
79,86,0,766,777,11,2.47,7.54,13.19
79,87,0,525,540,15,1.36,7.33,13.6
79,87,1,867,875,8,12.58,13.38,14.85
79,88,0,533,547,14,6.56,9.65,14.06
79,88,1,933,960,27,0.53,7.67,14.84
79,89,0,742,765,23,1.35,7.52,14.32
79,89,1,957,1027,70,0.24,7.52,14.92
80,75,0,621,638,17,6.3,9.84,14.78
80,75,1,641,663,22,8.91,11.14,14.59
80,76,0,425,449,24,2.13,7.89,14.86
80,76,1,788,792,4,12.32,13.02,13.73
80,78,0,628,637,9,2.14,8.01,14.38
80,78,1,949,958,9,1.89,8.01,14.88
80,79,0,423,446,23,5.72,9.56,14.98
80,79,1,886,899,13,7.44,10.43,14.72
80,81,0,507,518,11,8.7,11.1,14.7
80,81,1,676,686,10,6.3,9.65,14.45
80,81,2,707,724,17,1.79,7.49,13.8
80,83,0,589,606,17,1.58,7.48,13.92
80,84,0,513,524,11,2.53,7.79,13.94
80,84,1,654,665,11,7.27,10.23,14.83
80,84,2,678,680,2,14.88,14.95,14.99
80,84,3,936,941,5,13.44,13.91,14.56
80,85,0,482,491,9,5.28,9.14,13.9
80,85,1,619,626,7,9.37,11.26,13.9
80,86,0,821,826,5,12.26,13.24,14.49
80,86,1,916,941,25,0.46,7.6,14.19
80,87,0,651,663,12,6.24,10,14.9
80,87,1,906,919,13,0.78,7.53,14.47
80,88,0,776,787,11,0.97,7.19,13.42
80,88,1,1023,1030,7,13.41,13.88,14.7
81,75,0,759,764,5,11.13,12.17,13.5
81,76,0,667,675,8,4.46,9.11,14.68
81,76,1,968,975,7,10.94,12.4,14.44
81,77,0,426,431,5,6.27,9.8,13.59
81,77,1,590,593,3,13.84,14.25,14.87
81,78,0,754,757,3,13.57,14.06,14.6
81,78,1,1007,1013,6,11.12,12.84,14.9
81,79,0,494,505,11,2.68,7.48,12.82
81,79,1,761,772,11,4.3,8.37,13.38
81,80,0,507,518,11,8.7,11.1,14.7
81,80,1,676,686,10,6.3,9.65,14.45
81,80,2,707,724,17,1.79,7.49,13.8
81,82,0,624,635,11,5.27,9.08,14.31
81,84,0,516,520,4,12.41,13.27,14.24
81,86,0,583,587,4,11.81,12.8,14.23
81,86,1,767,774,7,9.75,11.96,14.96
81,88,0,582,603,21,6.57,9.85,14.57
81,88,1,617,627,10,10.01,12.11,14.25
81,89,0,767,792,25,4.57,8.66,14.77
81,312,0,914,919,5,10,11.31,12.91
82,75,0,715,725,10,8.87,11.05,14.15
82,75,1,998,1006,8,12.06,13.25,14.96
82,78,0,579,591,12,0.51,7.69,14.79
82,78,1,767,791,24,0.25,7.45,14.28
82,78,2,978,988,10,6.72,9.93,14.84
82,81,0,624,635,11,5.27,9.08,14.31
82,84,0,778,804,26,0.48,7.51,14.52
82,84,1,841,852,11,6.94,10.28,14.97
82,84,2,958,967,9,9.84,11.76,14.55
82,85,0,818,830,12,6.79,10.39,14.99
82,86,0,733,742,9,9.39,11.65,14.91
82,88,0,867,890,23,8.94,11.66,14.87
82,89,0,430,504,74,3.89,8.92,14.86
83,75,0,611,616,5,11.08,12.22,13.86
83,75,1,795,804,9,2.47,8.3,14.51
83,75,2,888,897,9,2.24,8.08,14.32
83,76,0,534,539,5,9.47,11.01,12.92
83,77,0,494,507,13,1.99,7.49,13.63
83,77,1,779,787,8,8.32,10.77,14.64
83,78,0,701,709,8,1.64,7.8,13.79
83,79,0,653,673,20,4.2,8.74,14.62
83,79,1,682,692,10,9.83,11.77,14.45
83,80,0,589,606,17,1.58,7.38,13.92
83,85,0,695,700,5,11.51,12.79,14.45
83,86,0,625,628,3,13.48,13.99,14.7
83,86,1,802,810,8,1.4,7.7,14.86
83,87,0,475,486,11,7.25,10.29,14.91
83,87,1,782,794,12,11.29,12.62,14.99
83,88,0,702,713,11,12.28,13.35,14.99
83,88,1,783,795,12,0.85,8.12,14.91
83,89,0,865,884,19,7.95,10.47,14.34
83,160,0,973,994,21,4.02,8.79,14.96
84,75,0,730,736,6,14.14,14.38,14.72
84,75,1,1015,1022,7,9.7,11.82,14.67
84,76,0,490,497,7,5.7,9.42,13.88
84,76,1,875,887,12,12.04,13.1,14.98
84,76,2,894,916,22,1.8,10.71,14.88
84,77,0,596,607,11,4.82,8.74,13.65
84,77,1,709,713,4,13.46,13.95,14.66
84,78,0,765,775,10,13.26,13.79,14.59
84,78,1,778,792,14,9.14,11.36,14.68
84,78,2,999,1007,8,5.11,9.5,14.37
84,80,0,513,524,11,2.53,7.79,13.94
84,80,1,654,665,11,7.27,10.23,14.83
84,80,2,678,680,2,14.88,14.95,14.99
84,80,3,936,941,5,13.44,13.91,14.56
84,81,0,516,520,4,12.41,13.27,14.24
84,82,0,778,804,26,0.48,7.51,14.52
84,82,1,841,852,11,6.94,10.28,14.97
84,82,2,958,967,9,9.84,11.76,14.55
84,85,0,569,574,5,9.89,11.44,13.45
84,85,1,810,817,7,4.08,8.17,12.82
84,86,0,721,737,16,9.67,11.54,14.59
84,86,1,751,758,7,1.97,7.18,12.6
84,86,2,935,935,0,14.95,14.95,14.95
84,87,0,539,549,10,8.12,10.55,14.07
84,87,1,651,663,12,9.73,11.65,14.8
84,87,2,869,881,12,10.03,11.91,14.79
84,88,0,553,569,16,8.58,10.76,14.02
85,75,0,615,628,13,4.44,8.57,13.75
85,76,0,469,476,7,4.71,9.3,14.6
85,76,1,724,728,4,10.72,12.01,13.38
85,77,0,549,559,10,1.05,7.87,14.81
85,77,1,765,767,2,14.36,14.56,14.9
85,78,0,553,563,10,6.6,9.57,13.61
85,79,0,848,851,3,14.3,14.46,14.63
85,80,0,482,491,9,5.28,9.14,13.9
85,80,1,619,626,7,9.37,11.26,13.9
85,82,0,818,830,12,6.79,10.44,14.99
85,83,0,695,700,5,11.51,12.79,14.45
85,84,0,569,574,5,9.89,11.44,13.45
85,84,1,810,817,7,4.08,8.17,12.82
85,86,0,542,550,8,10.71,12.32,14.62
85,86,1,642,646,4,12.97,13.66,14.9
85,86,2,1003,1007,4,10.33,11.63,13.25
85,88,0,572,581,9,3.63,8.69,14.8
85,89,0,909,929,20,2.69,8.04,14.82
86,75,0,852,858,6,10.94,12.14,13.83
86,75,1,944,949,5,13.15,13.84,14.91
86,75,2,1050,1060,10,6.73,9.7,14.29
86,76,0,600,609,9,5.83,9.2,13.48
86,77,0,563,571,8,1.49,7.57,14.76
86,77,1,705,709,4,14.39,14.61,14.9
86,78,0,474,479,5,11.31,12.92,14.53
86,78,1,946,949,3,12.27,13.07,14.21
86,78,2,1041,1047,6,6.96,10.25,14.85
86,79,0,766,777,11,2.47,7.54,13.19
86,80,0,821,826,5,12.26,13.24,14.49
86,80,1,916,941,25,0.46,7.6,14.19
86,81,0,583,587,4,11.81,12.8,14.23
86,81,1,767,774,7,9.75,11.96,14.96
86,82,0,733,742,9,9.39,11.65,14.91
86,83,0,625,628,3,13.48,13.99,14.7
86,83,1,802,810,8,1.4,7.7,14.86
86,84,0,721,737,16,9.67,11.54,14.59
86,84,1,751,758,7,1.97,7.18,12.6
86,84,2,935,935,0,14.95,14.95,14.95
86,85,0,542,550,8,10.71,12.32,14.62
86,85,1,642,646,4,12.97,13.66,14.9
86,85,2,1003,1007,4,10.33,11.63,13.25
86,87,0,916,918,2,14.51,14.67,14.75
86,87,1,976,988,12,8.24,10.49,13.6
86,88,0,450,451,1,11.78,12.77,13.77
86,88,1,474,484,10,3.38,8.31,13.87
86,88,2,582,590,8,1.7,7.53,13.6
87,75,0,929,932,3,14.37,14.58,14.87
87,76,0,513,519,6,10.5,11.97,13.77
87,76,1,632,642,10,5.57,9.19,14.34
87,76,2,848,871,23,3.17,8.34,14.67
87,76,3,925,934,9,10.9,12.26,14.37
87,77,0,786,793,7,9.81,11.58,13.97
87,78,0,495,510,15,1.55,7.73,14.47
87,79,0,525,540,15,1.36,7.33,13.6
87,79,1,867,875,8,12.58,13.38,14.85
87,80,0,651,663,12,6.24,10,14.9
87,80,1,906,919,13,0.78,7.53,14.47
87,83,0,475,486,11,7.25,10.29,14.91
87,83,1,782,794,12,11.29,12.62,14.99
87,84,0,539,549,10,8.12,10.55,14.07
87,84,1,651,663,12,9.73,11.65,14.8
87,84,2,869,881,12,10.03,11.91,14.79
87,86,0,916,918,2,14.51,14.67,14.75
87,86,1,976,988,12,8.24,10.49,13.6
87,88,0,529,531,2,14.92,14.94,14.97
87,88,1,786,807,21,9.56,11.42,14.37
88,76,0,514,523,9,8.61,10.9,13.99
88,76,1,947,958,11,7.62,10.54,14.6
88,77,0,590,594,4,13.2,13.85,14.69
88,78,0,472,487,15,9.19,12.46,14.79
88,78,1,705,713,8,0.72,7.22,13.49
88,78,2,815,822,7,11.18,12.54,14.39
88,79,0,533,547,14,6.56,9.65,14.06
88,79,1,933,960,27,0.53,7.67,14.84
88,80,0,776,787,11,0.97,7.19,13.42
88,80,1,1023,1024,1,13.49,14.1,14.7
88,81,0,582,603,21,6.57,9.85,14.57
88,81,1,617,627,10,10.01,12.22,14.25
88,82,0,867,890,23,8.94,11.75,14.87
88,83,0,702,713,11,12.28,13.35,14.99
88,83,1,783,795,12,0.85,8.12,14.91
88,84,0,553,569,16,8.58,10.76,14.02
88,85,0,572,581,9,3.63,8.69,14.8
88,86,0,474,484,10,3.38,8.31,13.87
88,86,1,582,590,8,1.7,7.53,13.6
88,87,0,529,531,2,14.92,14.94,14.97
88,87,1,786,807,21,9.56,11.42,14.37
88,89,0,952,961,9,13.38,13.94,14.95
89,75,0,746,760,14,4.26,8.76,14.65
89,75,1,899,903,4,13.97,14.3,14.85
89,76,0,962,965,3,14.73,14.81,14.89
89,78,0,594,601,7,11.71,12.73,14.32
89,78,1,739,750,11,2.32,8.01,14.61
89,79,0,742,765,23,1.35,7.52,14.32
89,79,1,957,1027,70,0.24,7.52,14.92
89,81,0,767,792,25,4.57,8.79,14.77
89,82,0,459,504,45,3.89,10.15,14.86
89,83,0,865,884,19,7.95,10.47,14.34
89,85,0,909,929,20,2.69,8.04,14.82
89,88,0,952,961,9,13.38,13.94,14.95
90,91,0,874,881,7,9.1,11.48,14.58
90,91,1,958,964,6,9.4,11.31,14.1
90,92,0,637,650,13,3.06,10.71,14.94
90,93,0,650,657,7,5.08,8.98,13.5
90,94,0,666,673,7,9.59,11.77,14.86
90,94,1,755,759,4,12.37,13.11,14.01
90,95,0,545,552,7,3.87,8.15,13.4
90,96,0,601,605,4,12.18,12.79,13.41
90,97,0,526,537,11,5.11,9.15,14.93
90,97,1,975,985,10,2.75,8.25,14.48
90,99,0,586,595,9,0.67,7.73,14.94
90,99,1,839,861,22,5.45,9.27,14.92
90,99,2,869,877,8,5.9,9.39,14.01
90,100,0,985,1007,22,9.25,11.4,14.81
90,101,0,811,819,8,1.16,7.94,14.67
90,102,0,669,676,7,6.07,9.56,13.86
90,102,1,915,916,1,14.47,14.64,14.8
90,103,0,613,643,30,0.43,7.75,13.91
90,103,1,809,816,7,1.65,6.92,12.19
90,103,2,986,993,7,3.74,8.1,13.41
91,90,0,874,881,7,9.1,11.48,14.58
91,90,1,958,964,6,9.4,11.31,14.1
91,92,0,448,465,17,5.57,9.17,14.17
91,92,1,709,713,4,12.32,13.24,14.91
91,95,0,445,461,16,7.11,9.99,14.08
91,95,1,616,623,7,6.42,9.75,14.63
91,95,2,713,721,8,6.29,9.77,14.44
91,97,0,461,482,21,4.88,10.31,14.87
91,97,1,704,714,10,4.6,9.45,15
91,98,0,635,646,11,4.58,8.83,13.99
91,98,1,994,1005,11,1.34,7.4,13.83
91,99,0,881,887,6,12.04,13.15,14.87
91,100,0,684,691,7,9.05,11.36,14.45
91,100,1,952,958,6,9.62,11.64,14.47
91,101,0,474,479,5,11.88,12.99,14.55
91,101,1,559,567,8,3.05,8,13.98
91,101,2,645,652,7,6.16,9.12,12.76
91,101,3,735,735,0,14.96,14.96,14.96
91,101,4,817,825,8,2.61,7.98,13.84
91,102,0,930,938,8,5.23,9.22,14.13
91,103,0,816,823,7,11.25,12.83,14.62
92,15,0,755,762,7,1.36,7.29,13.3
92,17,0,782,790,8,0.55,7.83,14.37
92,18,0,739,739,0,8.15,8.15,8.15
92,20,0,741,741,0,11.61,11.61,11.61
92,21,0,738,738,0,7.81,7.81,7.81
92,22,0,754,759,5,8.58,10.76,13.69
92,23,0,739,739,0,10.48,10.48,10.48
92,23,1,789,799,10,7.85,10.8,14.67
92,24,0,746,752,6,4.63,8.66,14.01
92,26,0,758,763,5,12.26,13.2,14.68
92,26,1,852,853,1,13.7,14.31,14.93
92,27,0,797,832,35,0.43,6.89,14.91
92,90,0,637,650,13,3.06,10.98,14.94
92,90,1,1075,1076,1,14.22,14.53,14.85
92,91,0,709,713,4,12.32,13.24,14.91
92,93,0,497,509,12,7.36,10.05,14.15
92,93,1,654,662,8,1.76,8.06,14.25
92,94,0,585,590,5,10.67,11.85,13.28
92,95,0,473,474,1,11.58,12.59,13.61
92,95,1,706,714,8,11.87,13.15,14.88
92,95,2,877,879,2,8.11,11.1,14.15
92,96,0,676,683,7,1.96,7.67,13.42
92,96,1,972,980,8,4.84,8.74,13.37
92,97,0,711,714,3,8.39,11.22,14.07
92,99,0,595,601,6,6.6,9.29,12.4
92,99,1,966,975,9,4.9,8.84,13.66
92,100,0,537,542,5,9.96,11.87,14.54
92,100,1,694,697,3,12.61,13.31,14.21
92,100,2,1033,1033,0,14.91,14.91,14.91
92,102,0,514,519,5,8.1,10.33,13.41
92,103,0,638,643,5,11.81,12.93,14.33
92,103,1,876,876,0,13.58,13.58,13.58
92,103,2,881,891,10,5.12,8.95,13.57
92,104,0,979,991,12,0.01,7.33,13.62
92,129,0,851,853,2,14.04,14.36,14.77
93,90,0,650,657,7,5.08,8.98,13.5
93,92,0,497,509,12,7.36,10.12,14.15
93,92,1,654,662,8,1.76,8.06,14.25
93,94,0,483,492,9,12.5,13.31,14.69
93,97,0,750,779,29,1.1,9.16,14.04
93,98,0,915,916,1,14.84,14.91,14.98
93,99,0,609,615,6,9.49,11.63,14.28
93,99,1,810,816,6,12.35,13.45,14.93
93,100,0,453,459,6,6.63,9.96,13.9
93,100,1,801,805,4,10.93,12.23,13.58
93,101,0,510,514,4,10.88,12.01,13.13
93,101,1,676,689,13,5.14,9.9,14.78
93,101,2,842,849,7,1.36,7.39,13.51
93,102,0,777,782,5,10.43,12.31,14.99
93,103,0,465,471,6,9.81,11.33,13.21
93,103,1,558,566,8,8,10.72,14.4
93,103,2,837,841,4,13.66,14.17,14.77
93,104,0,510,519,9,1.86,7.45,13.41
93,245,0,966,966,0,13.05,13.05,13.05
93,304,0,970,982,12,7.26,9.91,14.7
93,314,0,1013,1022,9,4.74,8.88,13.85
93,343,0,967,970,3,5.68,9.21,14.28
94,90,0,666,673,7,9.59,11.77,14.86
94,90,1,755,759,4,12.37,13.11,14.01
94,92,0,585,590,5,10.67,11.85,13.28
94,93,0,483,492,9,12.5,13.31,14.69
94,95,0,766,774,8,5.51,8.98,13.45
94,96,0,964,968,4,13.29,14.1,14.94
94,97,0,570,574,4,13.17,13.63,14.12
94,97,1,804,808,4,13.85,14.4,14.95
94,97,2,843,855,12,8.75,11.11,14.46
94,98,0,574,586,12,0.95,7.53,13.79
94,99,0,475,518,43,8.55,10.81,14.67
94,99,1,620,625,5,12.52,13.31,14.32
94,99,2,950,961,11,3.04,8.37,14.46
94,100,0,734,743,9,2.51,8.08,14.28
94,102,0,658,700,42,3.57,9.37,14.42
94,102,1,992,1000,8,8.52,11.33,14.98
94,104,0,455,456,1,13.57,14.04,14.51
94,104,1,965,975,10,6.8,10.05,14.52
95,90,0,545,552,7,3.87,8.15,13.4
95,91,0,616,623,7,6.42,9.75,14.63
95,91,1,713,721,8,6.29,9.77,14.44
95,92,0,468,474,6,10.24,12.41,14.86
95,92,1,706,714,8,11.87,13.15,14.88
95,92,2,877,879,2,8.11,11.1,14.15
95,94,0,766,774,8,5.51,8.98,13.45
95,96,0,840,843,3,13.65,14.12,14.66
95,96,1,1003,1008,5,10.47,12.26,14.82
95,97,0,475,499,24,1.61,7.92,14.9
95,97,1,1041,1059,18,1.69,8.27,14.81
95,98,0,534,549,15,0.75,7.82,14.93
95,98,1,981,983,2,14.62,14.71,14.79
95,99,0,683,689,6,10.05,12.1,14.66
95,99,1,793,801,8,2.96,8.56,14.89
95,99,2,907,907,0,14.97,14.97,14.97
95,99,3,1068,1079,11,2.18,9.03,14.88
95,100,0,880,882,2,14.35,14.56,14.79
95,100,1,1072,1079,7,7.85,10.27,14.64
95,101,0,481,483,2,14.28,14.52,14.99
95,101,1,742,748,6,10.38,12.18,14.29
95,101,2,902,917,15,1.9,7.83,14.44
95,101,3,1005,1013,8,5.55,9.6,14.79
95,101,4,1061,1071,10,10.32,12.02,14.74
95,102,0,1036,1048,12,1.72,7.41,14.91
95,103,0,496,505,9,2.86,7.86,13.53
95,103,1,591,600,9,4.74,8.86,13.84
95,103,2,688,692,4,13.03,13.64,14.52
95,104,0,480,486,6,11.51,12.89,14.6
95,104,1,998,1011,13,10.13,11.92,14.74
96,90,0,601,605,4,12.09,12.65,13.41
96,92,0,676,683,7,1.96,7.67,13.42
96,92,1,972,980,8,4.84,8.74,13.37
96,94,0,964,968,4,13.29,14.1,14.94
96,95,0,840,843,3,13.65,14.12,14.66
96,95,1,1003,1008,5,10.47,12.26,14.82
96,97,0,523,531,8,7.62,10.06,13.1
96,97,1,777,783,6,9.88,11.73,14.97
96,97,2,895,906,11,1.39,7.54,14.46
96,99,0,548,557,9,1.52,7.9,14.5
96,100,0,512,527,15,7.99,10.72,14.81
96,100,1,810,816,6,6.26,9.23,12.89
96,101,0,695,701,6,4.99,8.6,12.33
96,101,1,982,1012,30,2.26,8.97,14.58
96,102,0,718,753,35,6.2,9.74,14.92
96,103,0,763,769,6,3.55,7.78,12.06
96,103,1,901,908,7,12.63,13.42,14.7
96,103,2,931,937,6,8.79,10.98,13.74
96,104,0,826,834,8,7.65,10.79,14.7
96,104,1,942,969,27,8.21,10.79,14.83
96,104,2,1007,1014,7,10.43,12.36,14.9
97,90,0,526,537,11,5.11,9.15,14.93
97,90,1,975,985,10,2.75,8.25,14.48
97,91,0,461,482,21,4.88,10.51,14.87
97,91,1,705,714,9,4.6,8.9,15
97,92,0,711,714,3,8.39,11.22,14.07
97,93,0,750,779,29,1.1,8.85,14.04
97,94,0,570,574,4,13.17,13.63,14.12
97,94,1,804,808,4,13.85,14.4,14.95
97,94,2,843,855,12,8.75,11.11,14.46
97,95,0,475,499,24,1.61,7.92,14.9
97,95,1,1041,1055,14,1.69,7.07,14.54
97,96,0,523,531,8,7.62,10.06,13.1
97,96,1,777,783,6,9.88,11.73,14.97
97,96,2,895,906,11,1.39,7.48,14.46
97,98,0,564,574,10,11.05,12.45,14.48
97,98,1,923,940,17,3.56,8.26,14.11
97,99,0,456,464,8,5.32,9.34,14.16
97,99,1,647,654,7,8.54,10.99,14.22
97,99,2,838,844,6,10.38,12.1,14.95
97,99,3,930,939,9,1.44,7.61,13.97
97,99,4,1030,1034,4,13.08,13.83,14.66
97,100,0,877,883,6,8.77,10.85,13.94
97,100,1,965,978,13,3.64,9.89,14.89
97,101,0,473,482,9,8.5,10.96,14.8
97,101,1,583,588,5,12.8,13.63,14.94
97,101,2,1025,1025,0,14.91,14.91,14.91
97,102,0,595,599,4,11.51,12.42,13.37
97,102,1,1026,1047,21,9.51,11.99,14.96
97,103,0,496,498,2,13.9,14.19,14.59
97,103,1,738,746,8,4.13,8.78,13.88
97,103,2,901,908,7,3.07,8.16,13.82
97,104,0,484,484,0,14.84,14.84,14.84
97,104,1,621,623,2,14.65,14.76,14.93
98,91,0,635,646,11,4.58,8.83,13.99
98,91,1,994,1005,11,1.34,7.4,13.83
98,93,0,915,916,1,14.84,14.91,14.98
98,94,0,574,586,12,0.95,7.53,13.79
98,95,0,535,549,14,0.75,7.38,14.93
98,95,1,981,983,2,14.62,14.71,14.79
98,97,0,564,574,10,11.05,12.45,14.48
98,97,1,923,940,17,3.56,8.26,14.11
98,99,0,731,740,9,9.51,11.58,14.72
98,99,1,928,948,20,3.92,8.73,14.69
98,100,0,472,493,21,4.45,9.53,14.54
98,100,1,506,513,7,10.69,12.06,14.12
98,100,2,824,840,16,2.51,7.97,14.63
98,102,0,816,825,9,7.7,10.25,13.72
98,104,0,742,753,11,8.21,10.52,13.84
99,90,0,586,595,9,0.67,7.73,14.94
99,90,1,839,861,22,5.45,9.27,14.92
99,90,2,869,877,8,5.9,9.39,14.01
99,91,0,881,887,6,12.04,13.15,14.87
99,92,0,595,601,6,6.6,9.29,12.4
99,92,1,966,975,9,4.9,8.84,13.66
99,93,0,609,615,6,9.49,11.63,14.28
99,93,1,810,816,6,12.35,13.45,14.93
99,94,0,475,518,43,8.55,10.75,14.67
99,94,1,620,625,5,12.52,13.31,14.32
99,94,2,950,961,11,3.04,8.37,14.46
99,95,0,683,689,6,10.05,12.1,14.66
99,95,1,793,801,8,2.96,8.56,14.89
99,95,2,907,907,0,14.97,14.97,14.97
99,95,3,1068,1072,4,12.69,13.79,14.88
99,96,0,548,557,9,1.52,7.9,14.5
99,97,0,456,464,8,5.32,9.34,14.16
99,97,1,647,654,7,8.54,10.99,14.22
99,97,2,838,844,6,10.38,12.1,14.95
99,97,3,930,939,9,1.44,7.61,13.97
99,97,4,1030,1034,4,13.08,13.83,14.66
99,98,0,731,740,9,9.51,11.58,14.72
99,98,1,928,948,20,3.92,8.73,14.69
99,100,0,656,663,7,1.74,6.91,12.14
99,100,1,787,793,6,13.5,14.14,14.93
99,100,2,1065,1072,7,9.96,11.97,14.96
99,101,0,901,909,8,8.12,10.81,14.36
99,101,1,1055,1057,2,14.9,14.95,14.97
99,102,0,630,637,7,4.99,8.84,13.87
99,104,0,455,461,6,14.24,14.54,14.93
100,90,0,985,1007,22,9.25,11.4,14.81
100,91,0,684,691,7,9.05,11.36,14.45
100,91,1,952,958,6,9.62,11.64,14.47
100,92,0,537,542,5,9.96,11.87,14.54
100,92,1,694,697,3,12.61,13.31,14.21
100,92,2,1033,1033,0,14.91,14.91,14.91
100,93,0,453,459,6,6.63,9.96,13.9
100,93,1,801,805,4,10.93,12.23,13.58
100,94,0,734,743,9,2.51,8.08,14.28
100,95,0,880,882,2,14.35,14.56,14.79
100,96,0,512,527,15,7.99,10.72,14.81
100,96,1,810,816,6,6.26,9.23,12.89
100,97,0,877,883,6,8.77,10.85,13.94
100,97,1,965,978,13,3.64,9.74,14.89
100,98,0,472,493,21,4.45,9.58,14.54
100,98,1,506,513,7,10.69,12.06,14.12
100,98,2,824,840,16,2.51,7.97,14.63
100,99,0,656,663,7,1.74,6.91,12.14
100,99,1,787,793,6,13.5,14.14,14.93
100,102,0,821,827,6,4.04,8.22,12.61
100,103,0,887,891,4,11,12.25,13.62
100,103,1,988,989,1,14.53,14.56,14.59
100,104,0,867,876,9,4.15,8.6,14.35
101,90,0,811,819,8,1.16,7.94,14.67
101,91,0,474,479,5,11.88,12.99,14.55
101,91,1,559,567,8,3.05,8,13.98
101,91,2,645,652,7,6.16,9.12,12.76
101,91,3,735,735,0,14.96,14.96,14.96
101,91,4,817,825,8,2.61,7.98,13.84
101,93,0,510,514,4,10.88,12.01,13.13
101,93,1,676,689,13,5.14,9.87,14.78
101,93,2,842,849,7,1.36,7.39,13.51
101,95,0,481,483,2,14.28,14.52,14.99
101,95,1,742,748,6,10.38,12.18,14.29
101,95,2,902,917,15,1.9,7.83,14.44
101,95,3,1005,1013,8,5.55,9.6,14.79
101,96,0,695,701,6,4.99,8.6,12.33
101,96,1,982,1012,30,2.26,8.96,14.58
101,97,0,473,482,9,8.5,10.96,14.8
101,97,1,583,588,5,12.8,13.63,14.94
101,97,2,1025,1025,0,14.91,14.91,14.91
101,99,0,901,909,8,8.12,10.81,14.36
101,102,0,530,533,3,13.7,14.21,14.8
101,102,1,609,617,8,4.81,9.33,14.88
101,103,0,568,573,5,11.37,12.48,13.82
101,103,1,659,666,7,6,9.74,14.89
101,103,2,807,842,35,2.4,8.25,14.65
101,104,0,503,514,11,14.26,14.54,14.99
101,104,1,522,532,10,0.51,7.85,14.81
101,104,2,1009,1018,9,2.6,7.78,13.78
102,90,0,669,676,7,6.07,9.56,13.86
102,90,1,915,916,1,14.47,14.64,14.8
102,91,0,930,938,8,5.23,9.22,14.13
102,92,0,514,519,5,8.1,10.33,13.41
102,93,0,421,430,9,6.99,9.1,13.31
102,93,1,777,782,5,10.43,12.31,14.99
102,94,0,658,700,42,3.57,9.45,14.42
102,94,1,992,1000,8,8.52,11.33,14.98
102,95,0,1036,1040,4,2.99,8.95,14.91
102,96,0,718,753,35,6.2,9.74,14.92
102,97,0,595,599,4,11.51,12.42,13.37
102,97,1,1026,1039,13,9.51,11.19,14.96
102,98,0,816,825,9,7.7,10.25,13.72
102,99,0,630,637,7,4.99,8.84,13.87
102,100,0,821,827,6,4.04,8.22,12.61
102,101,0,530,533,3,13.7,14.21,14.8
102,101,1,609,617,8,4.81,9.33,14.88
102,103,0,862,868,6,7.8,10.76,14.49
102,103,1,964,965,1,14.36,14.46,14.55
102,104,0,533,559,26,0.87,7.26,14.1
102,104,1,573,579,6,14.33,14.6,14.99
103,90,0,446,459,13,6.04,9.51,14.26
103,90,1,613,643,30,0.43,7.94,13.91
103,90,2,809,816,7,1.65,6.92,12.19
103,90,3,986,993,7,3.74,8.1,13.41
103,91,0,816,823,7,11.25,13.07,14.78
103,92,0,638,643,5,11.81,12.93,14.33
103,92,1,876,876,0,13.58,13.58,13.58
103,92,2,881,891,10,5.12,8.95,13.57
103,93,0,465,471,6,9.81,11.33,13.21
103,93,1,558,566,8,8,10.72,14.4
103,93,2,837,841,4,13.66,14.17,14.77
103,95,0,496,505,9,2.86,7.86,13.53
103,95,1,591,600,9,4.74,8.86,13.84
103,95,2,688,692,4,13.03,13.64,14.52
103,96,0,763,769,6,3.55,7.78,12.06
103,96,1,901,908,7,12.63,13.42,14.7
103,96,2,931,937,6,8.79,10.98,13.74
103,97,0,496,498,2,13.9,14.19,14.59
103,97,1,738,746,8,4.13,8.83,13.88
103,97,2,901,908,7,3.07,8.16,13.82
103,100,0,887,891,4,11,12.25,13.62
103,100,1,988,989,1,14.53,14.56,14.59
103,101,0,568,573,5,11.37,12.48,13.82
103,101,1,659,666,7,6,9.74,14.89
103,101,2,807,842,35,2.4,8.19,14.65
103,102,0,862,868,6,7.8,10.76,14.49
103,102,1,964,965,1,14.36,14.46,14.55
103,104,0,928,934,6,11.36,12.57,14.18
104,92,0,979,991,12,0.01,7.33,13.62
104,93,0,510,519,9,1.86,7.45,13.41
104,94,0,965,975,10,6.8,10.05,14.52
104,95,0,480,486,6,11.51,12.89,14.6
104,95,1,998,1011,13,10.13,11.92,14.74
104,96,0,826,834,8,7.65,10.79,14.7
104,96,1,942,969,27,8.21,10.79,14.83
104,96,2,1007,1014,7,10.43,12.36,14.9
104,97,0,484,484,0,14.84,14.84,14.84
104,97,1,621,623,2,14.65,14.76,14.93
104,98,0,742,753,11,8.21,10.52,13.84
104,100,0,867,876,9,4.15,8.6,14.35
104,101,0,503,514,11,14.26,14.54,14.99
104,101,1,522,532,10,0.51,7.85,14.81
104,101,2,1009,1018,9,2.6,7.78,13.78
104,102,0,533,559,26,0.87,7.35,14.1
104,102,1,573,579,6,14.33,14.6,14.99
104,103,0,928,934,6,11.36,12.57,14.18
105,6,0,707,707,0,14.49,14.49,14.49
105,106,0,447,468,21,1.01,7.65,14.86
105,106,1,1048,1065,17,4.3,9.64,14.68
105,107,0,820,820,0,6.27,6.27,6.27
105,108,0,537,546,9,7.36,10.45,14.61
105,108,1,600,645,45,0.43,6.94,14.99
105,109,0,526,536,10,6.6,9.94,14.53
105,112,0,462,471,9,0.71,7.41,14.24
105,112,1,560,564,4,12.51,13.52,14.54
105,112,2,665,668,3,13.76,14.26,14.82
105,112,3,1038,1044,6,11.82,13.04,14.86
105,113,0,821,821,0,9.07,9.07,9.07
105,113,1,970,985,15,7.28,10.14,14.16
105,114,0,545,567,22,0.27,7.72,14.75
105,114,1,985,1019,34,5.05,9.06,14.85
105,114,2,1029,1055,26,1.67,7.69,14.55
105,116,0,506,516,10,7.93,10.73,14.45
105,116,1,820,820,0,14.48,14.48,14.48
105,116,2,941,949,8,9.88,11.85,14.55
105,118,0,865,872,7,10.67,12.12,14.18
105,118,1,1002,1015,13,2.72,7.8,13.84
105,119,0,1007,1013,6,11.27,12.61,14.97
105,210,0,754,758,4,12.19,13.22,14.46
105,218,0,797,802,5,9.68,11.35,13.59
105,219,0,717,727,10,1.78,7.54,13.25
105,220,0,791,800,9,10.51,12.59,14.78
105,223,0,781,790,9,1.87,7.54,13.6
106,105,0,447,468,21,1.01,7.65,14.86
106,105,1,1048,1055,7,4.3,7.86,14.03
106,107,0,655,663,8,1.84,7.84,13.93
106,108,0,716,729,13,0.2,7.44,14.7
106,110,0,633,642,9,2.08,8.17,14.57
106,110,1,1031,1041,10,9.88,11.57,14.02
106,111,0,493,515,22,1.3,8.41,14.42
106,112,0,465,475,10,10.73,12.23,14.72
106,112,1,606,609,3,12.4,13.18,14.29
106,113,0,548,558,10,0.26,7.97,14.69
106,113,1,945,946,1,14.93,14.95,14.98
106,113,2,949,953,4,11.33,12.44,13.8
106,114,0,638,651,13,3.69,8.71,14.93
106,114,1,1052,1055,3,10.41,12.27,14.26
106,115,0,705,708,3,14.28,14.54,14.8
106,115,1,1029,1038,9,9.78,11.54,14.21
106,117,0,542,548,6,9.92,11.71,14.37
106,117,1,719,724,5,11.12,12.34,13.88
106,117,2,978,986,8,3.69,8.6,14.45
106,118,0,497,507,10,5.78,9.29,14.87
106,118,1,819,825,6,14.16,14.42,14.83
106,119,0,874,876,2,13.26,13.63,13.85
106,119,1,1030,1036,6,6.44,9.76,13.74
107,17,0,835,835,0,13.98,13.98,13.98
107,17,1,840,845,5,12.27,13.23,14.6
107,18,0,836,846,10,2.9,7.5,14.52
107,23,0,911,927,16,4.35,9,14.84
107,28,0,835,835,0,10.55,10.55,10.55
107,28,1,933,935,2,7.63,10.15,12.74
107,105,0,820,820,0,6.27,6.27,6.27
107,106,0,655,663,8,1.84,7.08,13.93
107,106,1,1068,1068,0,14.45,14.45,14.45
107,109,0,598,602,4,12.36,13.3,14.89
107,110,0,421,434,13,2.41,7.6,13.77
107,110,1,957,986,29,3.37,8.18,14.26
107,113,0,825,828,3,12.9,13.68,14.87
107,113,1,960,967,7,9.25,11.13,13.71
107,114,0,467,481,14,1.94,7.86,14.82
107,114,1,672,676,4,14.35,14.57,14.91
107,114,2,938,938,0,10.12,10.12,10.12
107,114,3,1057,1068,11,3.14,8.57,14.08
107,115,0,511,518,7,12.87,13.56,14.72
107,115,1,571,582,11,2.56,8,14.49
107,115,2,820,830,10,3.58,8.46,14.3
107,116,0,630,641,11,1.22,8.19,13.78
107,116,1,748,791,43,9.75,12.96,14.93
107,116,2,815,816,1,14.66,14.78,14.9
107,116,3,939,940,1,12.99,13.91,14.83
107,117,0,701,707,6,9.83,11.68,14.16
107,118,0,697,704,7,5.51,9.69,14.81
107,118,1,786,789,3,13.78,14.15,14.53
107,118,2,1020,1030,10,3.59,8.64,14.45
107,119,0,441,453,12,2.65,8.26,13.75
107,119,1,529,533,4,12.75,13.53,14.99
107,119,2,700,703,3,12.81,13.39,13.98
107,123,0,852,871,19,0.57,7.45,14.48
108,105,0,537,546,9,7.36,10.45,14.61
108,105,1,600,645,45,0.43,6.86,14.99
108,106,0,716,729,13,0.2,7.44,14.7
108,109,0,490,501,11,10.33,11.95,14.57
108,109,1,584,596,12,4.7,9.08,14.81
108,110,0,793,798,5,12.96,13.66,14.66
108,111,0,594,597,3,14.35,14.55,14.84
108,111,1,766,784,18,2.33,7.73,14.13
108,112,0,672,675,3,13.78,14.26,14.96
108,112,1,982,982,0,5.37,5.37,5.37
108,113,0,994,1002,8,13.68,14.17,14.99
108,115,0,474,487,13,0.65,6.9,14.97
108,115,1,982,982,0,12.91,12.91,12.91
108,117,0,594,598,4,13.77,14.2,14.85
108,117,1,713,724,11,5.66,9.28,14.07
108,118,0,549,552,3,13.02,13.41,13.85
108,118,1,989,997,8,10.94,12.25,14.03
108,119,0,822,832,10,6.27,9.8,14.49
108,130,0,884,884,0,8.47,8.47,8.47
109,105,0,526,536,10,6.6,9.94,14.53
109,107,0,598,602,4,12.36,13.3,14.89
109,108,0,490,501,11,10.33,11.95,14.57
109,108,1,584,596,12,4.7,9.08,14.81
109,108,2,1026,1039,13,10.13,11.89,14.94
109,108,3,1043,1060,17,3.67,8.32,14.32
109,110,0,698,704,6,10.74,12.05,13.85
109,111,0,590,608,18,7.47,10.34,14.6
109,112,0,939,943,4,13.34,13.88,14.53
109,113,0,537,538,1,14.95,14.96,14.98
109,113,1,1037,1055,18,7.17,9.73,13.73
109,114,0,814,830,16,7.07,10.02,14.16
109,116,0,872,881,9,4.82,9.29,14.83
109,116,1,1053,1063,10,2.23,6.03,14.44
109,117,0,592,620,28,7.99,10.57,14.56
109,118,0,655,664,9,1.45,8.13,14.94
109,119,0,810,820,10,12.69,13.51,14.85
110,106,0,633,642,9,2.08,8.17,14.57
110,107,0,957,986,29,3.37,8.18,14.26
110,108,0,793,798,5,12.96,13.66,14.66
110,109,0,698,704,6,10.74,12.05,13.85
110,111,0,659,673,14,2.01,8.18,14.78
110,113,0,556,563,7,6.91,10.14,14.67
110,113,1,718,725,7,6.39,9.84,14.13
110,113,2,964,969,5,10.87,12.31,14.22
110,114,0,618,636,18,10.92,12.36,14.73
110,114,1,942,958,16,1.39,7.63,14.81
110,116,0,687,693,6,14.22,14.49,14.88
110,118,0,512,519,7,6.5,9.72,14.3
110,119,0,839,848,9,11.88,12.98,14.6
110,119,1,1022,1022,0,14.87,14.87,14.87
111,106,0,493,515,22,1.3,8.56,14.42
111,108,0,594,597,3,14.35,14.55,14.84
111,108,1,766,784,18,2.33,7.81,14.13
111,109,0,590,608,18,7.47,10.34,14.6
111,110,0,659,673,14,2.01,8.18,14.78
111,112,0,644,653,9,6.97,10.31,14.62
111,116,0,483,489,6,11.66,12.8,14.63
111,116,1,847,857,10,1,7.43,14.42
111,116,2,972,976,4,14.17,14.54,14.99
111,116,3,1000,1027,27,4.69,8.77,14.26
111,117,0,561,573,12,6.33,9.68,14.32
111,117,1,580,618,38,3.01,8.13,14.48
111,118,0,490,506,16,1.49,8.31,14.58
111,118,1,700,706,6,13.64,14.14,14.93
111,119,0,697,706,9,8.58,10.91,14.32
112,15,0,770,788,18,4,8.7,14.77
112,16,0,719,719,0,11.56,11.56,11.56
112,22,0,762,777,15,3.25,8.27,14.33
112,25,0,828,843,15,3.75,8.49,14.9
112,27,0,721,726,5,13.22,13.77,14.57
112,28,0,720,720,0,2.08,2.08,2.08
112,28,1,728,733,5,14.49,14.68,14.99
112,28,2,759,791,32,6.68,9.87,14.82
112,105,0,462,471,9,0.71,7.41,14.24
112,105,1,560,564,4,12.51,13.52,14.54
112,105,2,665,668,3,13.76,14.26,14.82
112,105,3,1038,1044,6,11.82,13.04,14.86
112,106,0,465,475,10,10.73,12.23,14.72
112,106,1,606,609,3,12.4,13.18,14.29
112,108,0,672,675,3,13.78,14.26,14.96
112,108,1,982,982,0,5.37,5.37,5.37
112,109,0,939,943,4,13.34,13.88,14.53
112,110,0,854,854,0,4.51,4.51,4.51
112,111,0,644,653,9,6.97,10.31,14.62
112,113,0,623,629,6,3.91,7.98,12.4
112,114,0,556,570,14,8.01,10.9,14.98
112,114,1,1033,1042,9,10.68,12.16,14.57
112,115,0,657,667,10,6.61,9.54,13.37
112,115,1,974,984,10,4.6,8.83,14.32
112,116,0,583,585,2,13.96,14.31,14.69
112,116,1,962,967,5,12.84,13.61,14.64
112,117,0,425,438,13,4.97,8.95,14.3
112,117,1,458,465,7,7.43,10.07,13.37
112,118,0,572,593,21,6.25,9.71,14.74
112,118,1,897,904,7,1.27,7.77,14.28
112,119,0,855,855,0,8.86,8.86,8.86
112,119,1,863,867,4,13.85,14.32,14.81
112,145,0,777,798,21,6.44,9.87,14.78
112,172,0,730,730,0,12.6,12.6,12.6
113,105,0,821,821,0,9.07,9.07,9.07
113,105,1,970,985,15,7.28,10.14,14.16
113,106,0,548,558,10,0.26,7.97,14.69
113,106,1,945,946,1,14.93,14.95,14.98
113,106,2,949,953,4,11.33,12.44,13.8
113,107,0,825,828,3,12.9,13.68,14.87
113,107,1,960,967,7,9.25,11.13,13.71
113,108,0,994,1002,8,13.68,14.17,14.99
113,108,1,1036,1044,8,6.47,8.98,13.88
113,109,0,537,538,1,14.95,14.96,14.98
113,109,1,1037,1044,7,8.95,10.3,13.3
113,110,0,556,563,7,6.91,10.14,14.67
113,110,1,718,725,7,6.39,9.84,14.13
113,110,2,964,969,5,10.87,12.31,14.22
113,112,0,623,629,6,3.91,7.98,12.4
113,114,0,977,989,12,9.4,11.44,14.35
113,115,0,582,592,10,0.55,7.87,14.79
113,115,1,894,896,2,14.39,14.55,14.75
113,116,0,699,710,11,0.41,7.46,14.51
113,116,1,826,828,2,14.44,14.74,14.95
113,117,0,686,698,12,3.18,8,13.74
113,117,1,928,933,5,12.44,13.25,14.5
113,118,0,461,467,6,6.13,9.55,13.88
113,118,1,615,616,1,14.57,14.73,14.9
113,118,2,688,693,5,10.28,11.99,14.72
113,118,3,764,770,6,6.77,9.65,12.8
113,118,4,839,846,7,0.94,7.76,14.09
113,118,5,915,923,8,0.68,8.14,14.93
113,118,6,991,998,7,3.21,8.07,13.6
113,119,0,561,571,10,1.64,7.69,14.37
113,119,1,684,690,6,10.67,12.04,13.73
113,119,2,784,791,7,3.27,8.05,13.28
113,119,3,891,896,5,10.23,11.95,14.65
114,105,0,545,567,22,0.27,7.67,14.75
114,105,1,985,1019,34,5.05,9.06,14.85
114,105,2,1029,1055,26,1.67,7.69,14.55
114,106,0,638,651,13,3.69,8.71,14.93
114,106,1,1052,1077,25,10.41,11.47,14.26
114,107,0,480,481,1,11.41,12.39,13.38
114,107,1,672,676,4,14.35,14.57,14.91
114,107,2,938,938,0,10.12,10.12,10.12
114,107,3,1057,1077,20,3.07,6.25,14.08
114,109,0,814,830,16,7.07,10.02,14.16
114,110,0,618,636,18,10.92,12.36,14.73
114,110,1,942,958,16,1.39,7.63,14.81
114,112,0,556,570,14,8.01,10.9,14.98
114,112,1,1033,1042,9,10.68,12.16,14.57
114,113,0,977,989,12,9.4,11.44,14.35
114,116,0,595,609,14,1.41,7.54,13.3
114,117,0,828,850,22,3.9,8.71,14.95
114,118,0,718,727,9,10.52,12.09,14.75
114,118,1,737,749,12,8.41,10.65,13.9
114,118,2,999,1013,14,1.8,7.85,14.74
114,119,0,721,724,3,14.47,14.64,14.85
114,119,1,802,817,15,5.56,9.26,14.26
114,119,2,1006,1018,12,4.37,8.53,13.93
115,106,0,705,708,3,14.28,14.54,14.8
115,106,1,1029,1038,9,9.78,11.54,14.21
115,107,0,511,518,7,12.87,13.56,14.72
115,107,1,571,582,11,2.56,8,14.49
115,107,2,820,830,10,3.58,8.19,14.3
115,108,0,469,487,18,0.65,8.44,14.97
115,108,1,982,982,0,12.91,12.91,12.91
115,109,0,450,458,8,9.29,11.88,14.69
115,110,0,1042,1046,4,12.44,13.58,14.78
115,112,0,657,667,10,6.61,9.54,13.37
115,112,1,974,984,10,4.6,8.83,14.32
115,113,0,582,592,10,0.55,7.87,14.79
115,113,1,894,896,2,14.39,14.55,14.75
115,116,0,521,532,11,3.18,8.57,14.73
115,118,0,848,858,10,0.51,7.12,13.47
115,119,0,500,511,11,9.16,11.43,14.68
115,119,1,543,559,16,9.55,11.69,14.92
115,119,2,634,644,10,9.74,11.63,14.74
115,119,3,738,752,14,10.72,12.29,14.72
115,119,4,766,776,10,4.07,8.6,14.48
115,119,5,901,907,6,12.91,13.55,14.34
115,119,6,933,946,13,2.91,8.29,14.64
115,119,7,1035,1040,5,13.52,13.98,14.7
116,105,0,506,516,10,7.93,10.73,14.45
116,105,1,820,820,0,14.48,14.48,14.48
116,105,2,941,949,8,9.88,11.85,14.55
116,107,0,630,641,11,1.22,8.19,13.78
116,107,1,748,791,43,9.75,12.92,14.93
116,107,2,815,816,1,14.66,14.78,14.9
116,107,3,939,940,1,12.99,13.91,14.83
116,108,0,1055,1056,1,12.11,12.98,13.85
116,109,0,872,881,9,4.82,9.29,14.83
116,109,1,1053,1056,3,4.46,9.42,14.44
116,110,0,687,693,6,14.22,14.49,14.88
116,111,0,483,489,6,11.66,12.8,14.63
116,111,1,847,857,10,1,7.43,14.42
116,111,2,972,976,4,14.17,14.54,14.99
116,111,3,1000,1027,27,4.69,8.77,14.26
116,112,0,583,585,2,13.96,14.31,14.69
116,112,1,962,967,5,12.84,13.61,14.64
116,113,0,699,710,11,0.41,7.46,14.51
116,113,1,826,828,2,14.44,14.74,14.95
116,114,0,595,609,14,1.41,7.41,13.3
116,115,0,521,532,11,3.18,8.57,14.73
116,118,0,481,487,6,11.69,12.97,14.7
116,118,1,581,586,5,10.5,12.06,14.39
116,118,2,783,792,9,0.91,7.18,13.51
117,106,0,542,548,6,9.92,11.71,14.37
117,106,1,719,724,5,11.12,12.34,13.88
117,106,2,978,986,8,3.69,8.6,14.45
117,107,0,701,707,6,9.83,11.68,14.16
117,108,0,594,598,4,13.77,14.2,14.85
117,108,1,713,724,11,5.66,9.28,14.07
117,109,0,592,620,28,7.99,10.57,14.56
117,111,0,561,573,12,6.33,9.68,14.32
117,111,1,580,618,38,3.01,8.13,14.48
117,112,0,458,465,7,7.43,10.07,13.37
117,113,0,686,698,12,3.18,8,13.74
117,113,1,928,933,5,12.44,13.25,14.5
117,114,0,828,850,22,3.9,8.71,14.95
117,118,0,684,698,14,8.37,10.9,14.68
117,119,0,673,681,8,9.34,12.01,14.94
118,105,0,865,872,7,10.67,12.12,14.18
118,105,1,1002,1015,13,2.72,7.8,13.84
118,106,0,497,507,10,5.78,9.9,14.87
118,106,1,819,825,6,14.16,14.42,14.83
118,107,0,697,704,7,5.51,9.69,14.81
118,107,1,786,789,3,13.78,14.15,14.53
118,107,2,1020,1030,10,3.59,8.64,14.45
118,108,0,549,552,3,13.02,13.41,13.85
118,108,1,989,997,8,10.94,12.25,14.03
118,109,0,655,664,9,1.45,8.13,14.94
118,110,0,512,519,7,6.5,9.72,14.3
118,111,0,490,506,16,1.49,8.33,14.58
118,111,1,700,706,6,13.64,14.14,14.93
118,112,0,572,593,21,6.25,9.76,14.74
118,112,1,897,904,7,1.27,7.77,14.28
118,113,0,461,467,6,6.13,9.55,13.88
118,113,1,615,616,1,14.57,14.73,14.9
118,113,2,688,693,5,10.28,11.99,14.72
118,113,3,764,770,6,6.77,9.65,12.8
118,113,4,839,845,6,0.94,7.04,14.09
118,113,5,915,923,8,0.68,8.14,14.93
118,113,6,991,998,7,3.21,8.07,13.6
118,114,0,718,727,9,10.52,12.09,14.75
118,114,1,737,749,12,8.41,10.65,13.9
118,114,2,999,1013,14,1.8,7.85,14.74
118,115,0,848,858,10,0.51,7.12,13.47
118,116,0,481,487,6,11.69,12.97,14.7
118,116,1,581,586,5,10.5,12.06,14.39
118,116,2,783,792,9,0.91,7.18,13.51
118,117,0,684,698,14,8.37,10.9,14.68
118,119,0,696,716,20,0.69,7.51,14.3
118,119,1,1004,1011,7,10.68,12.13,14.05
119,105,0,1007,1013,6,11.27,12.61,14.97
119,106,0,874,876,2,13.26,13.63,13.85
119,106,1,1030,1036,6,6.44,9.76,13.74
119,107,0,441,453,12,2.65,8.49,13.75
119,107,1,529,533,4,12.75,13.53,14.99
119,107,2,700,703,3,12.81,13.39,13.98
119,108,0,822,832,10,6.27,9.8,14.49
119,109,0,810,820,10,12.69,13.51,14.85
119,110,0,839,848,9,11.88,13.11,14.6
119,110,1,1022,1037,15,3.39,8.65,14.87
119,111,0,697,706,9,8.58,10.91,14.32
119,112,0,855,855,0,8.86,8.86,8.86
119,112,1,863,867,4,13.85,14.32,14.81
119,113,0,561,571,10,1.64,7.69,14.37
119,113,1,684,690,6,10.67,12.04,13.73
119,113,2,784,791,7,3.27,8.05,13.28
119,113,3,891,896,5,10.23,11.95,14.65
119,114,0,460,469,9,11.61,12.8,14.55
119,114,1,721,724,3,14.47,14.64,14.85
119,114,2,802,817,15,5.56,9.26,14.26
119,114,3,1006,1018,12,4.37,8.53,13.93
119,115,0,500,511,11,9.16,11.43,14.68
119,115,1,543,559,16,9.55,11.69,14.92
119,115,2,634,644,10,9.74,11.63,14.74
119,115,3,738,752,14,10.72,12.29,14.72
119,115,4,766,775,9,4.07,8.01,12.99
119,115,5,901,907,6,12.91,13.55,14.34
119,115,6,933,945,12,2.91,7.8,13.89
119,115,7,1035,1040,5,13.52,13.98,14.7
119,117,0,673,681,8,9.34,11.65,14.94
119,118,0,696,716,20,0.69,7.51,14.3
119,118,1,1004,1011,7,10.68,12.13,14.05
120,121,0,862,871,9,1.25,7.45,13.65
120,121,1,996,1000,4,13.76,14.18,15
120,123,0,1006,1006,0,11.47,11.47,11.47
120,124,0,481,497,16,5.45,9.37,14.76
120,125,0,580,586,6,10.68,12.3,14.34
120,126,0,484,503,19,7.15,9.64,14.53
120,126,1,587,588,1,14.88,14.89,14.89
120,128,0,457,457,0,13.67,13.67,13.67
120,128,1,583,591,8,5.52,8.85,12.86
120,128,2,967,977,10,11.42,12.81,14.79
120,128,3,990,1032,42,3.69,8.49,14.84
120,130,0,771,771,0,9.03,9.03,9.03
120,131,0,890,893,3,13.39,13.71,14.06
120,132,0,593,595,2,7.4,9.96,12.53
120,132,1,816,831,15,4.37,8.91,13.79
120,133,0,582,595,13,3.45,7.57,14.84
120,133,1,812,832,20,0.51,6.76,14.16
120,133,2,964,976,12,3.18,7.87,13.16
120,134,0,828,831,3,13.88,14.31,14.88
120,134,1,913,918,5,9.58,11.21,13.43
121,120,0,862,871,9,1.25,7.45,13.65
121,120,1,995,1000,5,13.76,14.27,15
121,122,0,489,504,15,8.13,10.7,14.52
121,122,1,605,614,9,6.89,10.03,14.34
121,122,2,878,894,16,3.35,8.17,14.05
121,122,3,936,939,3,13.58,14.04,14.71
121,123,0,439,446,7,10.5,11.86,14.36
121,123,1,634,638,4,12.94,13.62,14.37
121,123,2,642,719,77,1.01,7.59,14.77
121,123,3,725,727,2,14.36,14.57,14.94
121,123,4,1005,1005,0,10,10,10
121,125,0,786,794,8,3.15,8.46,14.67
121,126,0,572,590,18,2.97,8.26,14.54
121,127,0,466,480,14,0.99,7.89,14.45
121,127,1,670,691,21,2.59,8.03,14.82
121,128,0,577,585,8,9.74,11.81,14.6
121,128,1,683,692,9,1.4,7.89,14.39
121,129,0,947,947,0,10.41,10.41,10.41
121,130,0,501,508,7,7.74,10.21,13.76
121,131,0,818,833,15,2.83,7.35,14.3
121,131,1,972,983,11,9.81,11.67,14.45
121,132,0,586,595,9,2.33,8.3,14.57
121,133,0,576,588,12,7.53,10.43,14.48
121,133,1,1044,1054,10,13.5,13.87,14.67
121,134,0,495,506,11,5.8,10.05,14.15
121,134,1,738,741,3,14.01,14.27,14.6
122,121,0,489,504,15,8.13,10.83,14.52
122,121,1,605,614,9,6.89,10.03,14.34
122,121,2,878,894,16,3.35,8.17,14.05
122,121,3,936,939,3,13.58,14.04,14.71
122,123,0,515,524,9,6.08,9.32,13.45
122,124,0,864,872,8,6.61,9.85,14.79
122,124,1,954,963,9,1.28,7.56,13.88
122,125,0,901,906,5,11.15,12.81,14.97
122,126,0,667,674,7,4.74,9.34,14.89
122,127,0,629,633,4,10.78,11.97,13.18
122,128,0,771,775,4,11.96,12.81,13.81
122,128,1,780,806,26,5.21,9.17,14.58
122,129,0,465,476,11,9.73,11.46,13.94
122,130,0,510,520,10,13.42,13.91,14.7
122,131,0,758,766,8,2.26,7.52,13.21
122,132,0,463,465,2,9.55,11.4,13.37
122,132,1,518,524,6,12.66,13.57,14.96
122,134,0,484,528,44,7.36,10.42,14.98
122,134,1,1032,1039,7,1.01,7.62,14.33
123,19,0,845,845,0,11.19,11.19,11.19
123,20,0,867,872,5,10.64,12.09,14.17
123,25,0,887,898,11,1.17,8.04,14.96
123,28,0,846,846,0,7.61,7.61,7.61
123,29,0,894,902,8,10.57,12.09,14.33
123,107,0,852,871,19,0.57,7.45,14.48
123,120,0,1006,1006,0,11.47,11.47,11.47
123,121,0,634,638,4,12.94,13.62,14.37
123,121,1,642,719,77,1.01,7.59,14.77
123,121,2,725,727,2,14.36,14.57,14.94
123,121,3,1005,1005,0,10,10,10
123,122,0,515,524,9,6.08,9.32,13.45
123,125,0,585,593,8,1.47,7.27,13.09
123,126,0,529,536,7,7.33,9.9,13.22
123,126,1,595,607,12,8.62,11.09,14.71
123,126,2,653,660,7,8.98,11.21,14.14
123,127,0,673,689,16,1.63,7.6,14.18
123,128,0,589,595,6,9.96,11.54,13.57
123,128,1,684,692,8,3.03,8.01,13.99
123,128,2,1006,1006,0,14.26,14.26,14.26
123,128,3,1035,1043,8,2.99,7.7,12.54
123,129,0,527,534,7,5.22,8.45,12.3
123,129,1,621,627,6,9.65,11.73,14.47
123,129,2,754,763,9,13.72,14.17,14.85
123,129,3,777,791,14,5.97,9.38,14.25
123,132,0,513,519,6,7.22,9.68,12.59
123,134,0,620,628,8,4.85,8.92,13.97
123,134,1,729,738,9,3.13,7.93,13.38
123,202,0,943,946,3,11.99,12.68,13.49
123,203,0,926,926,0,11.91,11.91,11.91
123,204,0,928,933,5,6.76,9.25,13.27
123,205,0,927,927,0,13.5,13.5,13.5
123,208,0,947,951,4,13.93,14.25,14.58
123,208,1,972,989,17,7.26,9.78,14.73
124,120,0,481,497,16,5.45,9.37,14.76
124,122,0,864,872,8,6.61,9.85,14.79
124,122,1,954,963,9,1.28,7.56,13.88
124,125,0,597,603,6,11.68,12.71,14.08
124,126,0,480,499,19,0.28,6.12,14.22
124,127,0,660,671,11,6.5,9.86,14.76
124,127,1,883,890,7,9.25,11.26,14.39
124,128,0,893,895,2,14.49,14.67,14.97
124,131,0,666,676,10,11.49,13.03,14.87
124,140,0,705,714,9,12.48,13.28,14.5
124,285,0,736,751,15,1.9,7.72,14.36
124,289,0,694,694,0,12.28,12.28,12.28
124,289,1,708,720,12,1.34,7.37,13.46
124,290,0,695,698,3,11.11,13.67,14.95
124,294,0,800,807,7,10.24,11.73,13.89
124,298,0,723,736,13,4.53,8.34,14.49
124,298,1,803,812,9,12.86,13.52,14.95
125,120,0,580,586,6,10.68,12.3,14.34
125,121,0,786,794,8,3.15,8.46,14.67
125,122,0,901,906,5,11.15,12.81,14.97
125,122,1,1054,1062,8,12.2,13.22,14.64
125,123,0,585,593,8,1.47,7.27,13.09
125,124,0,597,603,6,11.68,12.71,14.08
125,126,0,922,934,12,9.17,11.39,14.57
125,127,0,500,502,2,14.31,14.56,14.83
125,127,1,836,843,7,3.65,8.38,13.69
125,127,2,921,929,8,2.67,8.01,14.52
125,128,0,506,592,86,3.15,8.19,14.89
125,128,1,637,647,10,4.82,9.36,14.99
125,128,2,735,743,8,6.88,9.75,13.86
125,128,3,831,839,8,9.21,11.58,14.61
125,128,4,929,935,6,11.01,12.32,14.28
125,128,5,1026,1030,4,13.35,13.93,14.56
125,130,0,664,674,10,5.93,9.38,14.19
125,130,1,1001,1010,9,1.44,7.21,13.07
125,131,0,677,707,30,3.52,8.4,14.75
125,131,1,928,937,9,2.64,8.24,14.26
125,131,2,1038,1051,13,5.29,9.2,14.91
125,132,0,725,733,8,2.83,8.39,14.63
125,132,1,1011,1014,3,13.57,14.18,14.88
125,133,0,500,507,7,12.56,13.5,14.86
125,133,1,568,582,14,3.87,8.47,14.03
126,6,0,708,708,0,14.12,14.12,14.12
126,120,0,484,503,19,7.15,9.72,14.53
126,120,1,587,588,1,14.88,14.89,14.89
126,121,0,572,590,18,2.97,8.26,14.54
126,122,0,667,674,7,4.74,9.34,14.89
126,123,0,529,536,7,7.33,9.9,13.22
126,123,1,595,607,12,8.62,11.09,14.71
126,123,2,653,660,7,8.98,11.21,14.14
126,124,0,479,499,20,0.28,6.41,14.22
126,125,0,922,934,12,9.17,11.39,14.57
126,127,0,915,926,11,5.56,9.02,13.47
126,128,0,576,589,13,7.71,10.61,14.88
126,128,1,924,937,13,1.73,7.97,14.94
126,129,0,531,538,7,4.26,8.42,13.45
126,130,0,624,630,6,6.03,8.9,12.06
126,130,1,982,994,12,8.49,11.08,14.85
126,131,0,930,934,4,14.41,14.56,14.74
126,132,0,587,591,4,12.36,13.1,13.9
126,133,0,577,588,11,5.94,9.65,14.83
126,134,0,451,459,8,2.03,8.46,14.49
126,134,1,853,867,14,7.43,10.05,13.74
126,134,2,956,965,9,10.99,12.48,14.78
126,214,0,801,802,1,12.79,13.71,14.63
126,215,0,749,766,17,6.92,9.65,14.03
126,216,0,706,720,14,1.93,7.92,14.98
126,220,0,696,713,17,1.15,7.01,14.34
126,222,0,779,783,4,13.26,13.91,14.58
126,318,0,724,742,18,6.49,10.07,14.99
127,121,0,476,480,4,2.37,8.26,14.19
127,121,1,670,691,21,2.59,8.03,14.82
127,122,0,629,633,4,10.78,11.97,13.18
127,123,0,673,689,16,1.63,7.6,14.18
127,124,0,660,671,11,6.5,9.86,14.76
127,124,1,883,890,7,9.25,11.26,14.39
127,125,0,500,502,2,14.31,14.56,14.83
127,125,1,836,843,7,3.65,8.38,13.69
127,125,2,921,929,8,2.67,8.01,14.52
127,126,0,915,926,11,5.56,9.02,13.47
127,128,0,492,499,7,9.25,11.33,14.52
127,128,1,684,690,6,9.19,11.29,14.47
127,128,2,840,849,9,12.24,13.28,14.76
127,129,0,735,741,6,9.25,11.66,14.79
127,129,1,993,1001,8,5.17,9.3,14.13
127,130,0,574,577,3,13.66,14.13,14.77
127,132,0,782,803,21,2.31,8.45,14.47
127,132,1,1046,1051,5,11.33,12.58,14.4
127,133,0,498,501,3,14.13,14.29,14.46
127,134,0,643,651,8,3.71,8.47,14.41
128,120,0,442,457,15,2.05,7.43,13.67
128,120,1,583,591,8,5.52,8.85,12.86
128,120,2,967,977,10,11.42,12.81,14.79
128,120,3,990,1032,42,3.69,8.49,14.84
128,121,0,577,585,8,9.74,11.81,14.6
128,121,1,683,692,9,1.4,7.89,14.39
128,122,0,771,775,4,11.96,12.81,13.81
128,122,1,780,806,26,5.21,9.17,14.58
128,123,0,589,595,6,9.96,11.54,13.57
128,123,1,684,692,8,3.03,8.01,13.99
128,123,2,1006,1006,0,14.26,14.26,14.26
128,123,3,1035,1043,8,2.99,7.7,12.54
128,124,0,424,433,9,3.27,7.7,14.34
128,124,1,893,895,2,14.49,14.67,14.97
128,125,0,506,592,86,3.15,8.18,14.89
128,125,1,637,647,10,4.82,9.39,14.99
128,125,2,735,743,8,6.88,9.75,13.86
128,125,3,831,839,8,9.21,11.58,14.61
128,125,4,929,935,6,11.01,12.32,14.28
128,125,5,1026,1030,4,13.35,13.93,14.56
128,126,0,576,589,13,7.71,10.61,14.88
128,126,1,924,937,13,1.73,7.97,14.94
128,127,0,492,499,7,9.25,11.33,14.52
128,127,1,684,690,6,9.19,11.29,14.47
128,127,2,840,849,9,12.24,13.28,14.76
128,130,0,784,788,4,13.81,14.21,14.8
128,131,0,932,949,17,2.42,8.09,14.97
128,133,0,492,506,14,1.95,7.84,14.96
128,133,1,572,590,18,3.41,8.57,14.84
128,133,2,958,973,15,8.13,10.72,14.6
129,22,0,916,931,15,3.05,8.47,14.85
129,26,0,844,858,14,3.13,8.89,13.46
129,92,0,851,853,2,14.04,14.36,14.77
129,121,0,947,947,0,10.41,10.41,10.41
129,122,0,465,476,11,9.73,11.46,13.94
129,123,0,527,534,7,5.22,8.45,12.3
129,123,1,621,627,6,9.65,11.73,14.47
129,123,2,754,763,9,13.72,14.17,14.85
129,123,3,777,791,14,5.97,9.38,14.25
129,126,0,531,538,7,4.26,8.42,13.45
129,127,0,735,741,6,9.25,11.66,14.79
129,127,1,993,1001,8,5.17,9.3,14.13
129,130,0,487,491,4,14.42,14.67,14.95
129,130,1,596,601,5,10.49,12.13,14.74
129,130,2,703,714,11,1.62,7.53,14.93
129,130,3,811,818,7,3.89,8.44,14.06
129,131,0,482,491,9,7.55,10.51,14.77
129,131,1,806,815,9,7.24,10.61,14.32
129,131,2,1058,1058,0,14.62,14.62,14.62
129,132,0,662,669,7,8.18,10.87,14.41
129,133,0,689,704,15,2.03,7.85,14.22
129,133,1,1008,1023,15,0.59,7.55,14.81
129,134,0,473,485,12,2.78,8,13.89
129,134,1,576,625,49,7.57,11.83,14.82
129,333,0,866,866,0,10.71,10.71,10.71
130,108,0,884,884,0,8.47,8.47,8.47
130,120,0,771,771,0,9.03,9.03,9.03
130,121,0,501,508,7,7.74,10.21,13.76
130,122,0,510,520,10,13.42,13.91,14.7
130,125,0,664,674,10,5.93,9.38,14.19
130,125,1,1001,1010,9,1.44,7.21,13.07
130,126,0,624,630,6,6.03,8.9,12.06
130,126,1,982,994,12,8.49,11.08,14.85
130,127,0,574,577,3,13.66,14.13,14.77
130,128,0,784,788,4,13.81,14.21,14.8
130,129,0,487,491,4,14.42,14.67,14.95
130,129,1,596,601,5,10.49,12.13,14.74
130,129,2,703,714,11,1.62,7.75,14.93
130,129,3,811,818,7,3.89,8.44,14.06
130,131,0,483,487,4,13.33,13.84,14.53
130,131,1,802,818,16,13.68,14.13,14.96
130,132,0,754,762,8,4.92,8.94,14.66
130,132,1,1014,1023,9,9.94,11.66,14.37
130,133,0,537,549,12,6.59,9.86,14.92
130,134,0,503,543,40,8.68,11.07,14.95
130,134,1,593,599,6,6.18,8.86,12.91
130,297,0,857,857,0,13.99,13.99,13.99
131,120,0,890,893,3,13.39,13.71,14.06
131,121,0,818,833,15,2.83,7.59,14.3
131,121,1,972,983,11,9.81,11.67,14.45
131,122,0,758,766,8,2.26,7.52,13.21
131,124,0,666,676,10,11.49,13.03,14.87
131,125,0,677,707,30,3.52,8.4,14.75
131,125,1,928,937,9,2.64,8.24,14.26
131,126,0,930,934,4,14.41,14.56,14.74
131,128,0,932,949,17,2.42,8.09,14.97
131,129,0,482,491,9,7.55,10.51,14.77
131,129,1,806,815,9,7.24,10.34,14.32
131,130,0,483,487,4,13.33,13.84,14.53
131,130,1,802,818,16,13.68,14.13,14.96
131,132,0,739,747,8,9.7,11.53,14.32
131,134,0,484,489,5,11.45,12.41,13.64
132,120,0,593,595,2,7.4,9.96,12.53
132,120,1,816,831,15,4.37,8.87,13.79
132,121,0,586,595,9,2.33,8.3,14.57
132,122,0,450,465,15,4.19,8.39,14.05
132,122,1,518,524,6,12.66,13.57,14.96
132,123,0,513,519,6,7.22,9.68,12.59
132,125,0,725,733,8,2.83,8.39,14.63
132,125,1,1011,1014,3,13.57,14.18,14.88
132,126,0,587,591,4,12.36,13.1,13.9
132,127,0,782,803,21,2.31,8.47,14.47
132,127,1,1046,1051,5,11.33,12.58,14.4
132,129,0,662,669,7,8.18,10.87,14.41
132,130,0,754,762,8,4.92,8.94,14.66
132,130,1,1014,1023,9,9.94,11.66,14.37
132,131,0,739,747,8,9.7,11.53,14.32
132,133,0,525,538,13,0.54,7.76,14.99
132,133,1,594,617,23,1.5,7.59,14.26
132,133,2,648,661,13,2.63,8.33,14.73
132,133,3,771,783,12,5.09,9.19,14.98
132,133,4,817,840,23,0.99,7.74,14.83
132,133,5,894,905,11,7.4,10.35,14.6
132,133,6,1006,1006,0,9.53,9.53,9.53
132,134,0,464,469,5,12.25,13.22,14.64
132,134,1,527,528,1,14.89,14.94,14.98
132,134,2,678,680,2,14.17,14.4,14.52
132,134,3,832,848,16,3.75,8.53,14.31
132,141,0,957,964,7,4.22,8.69,14.52
132,200,0,924,924,0,14.09,14.09,14.09
132,202,0,923,923,0,13.52,13.52,13.52
132,206,0,924,924,0,12.25,12.25,12.25
133,120,0,582,595,13,3.45,7.57,14.84
133,120,1,812,832,20,0.51,7.23,14.16
133,120,2,964,976,12,3.18,7.87,13.16
133,121,0,576,588,12,7.53,10.43,14.48
133,121,1,1044,1076,32,13.27,13.79,14.96
133,125,0,500,507,7,12.56,13.5,14.86
133,125,1,568,582,14,3.87,8.47,14.03
133,126,0,577,588,11,5.94,9.65,14.83
133,127,0,498,501,3,14.13,14.29,14.46
133,128,0,492,506,14,1.95,7.84,14.96
133,128,1,572,590,18,3.41,8.57,14.84
133,128,2,958,973,15,8.13,10.72,14.6
133,129,0,689,704,15,2.03,7.85,14.22
133,129,1,1008,1023,15,0.59,7.55,14.81
133,130,0,537,549,12,6.59,9.86,14.92
133,132,0,525,538,13,0.54,7.76,14.99
133,132,1,594,617,23,1.5,7.59,14.26
133,132,2,648,661,13,2.63,8.33,14.73
133,132,3,771,783,12,5.09,9.19,14.98
133,132,4,817,840,23,0.99,7.74,14.83
133,132,5,894,905,11,7.4,10.35,14.6
133,132,6,1006,1006,0,9.53,9.53,9.53
133,134,0,534,539,5,13.4,13.95,14.83
134,120,0,828,831,3,13.88,14.31,14.88
134,120,1,913,918,5,9.58,11.21,13.43
134,121,0,495,506,11,5.8,10.17,14.15
134,121,1,738,741,3,14.01,14.27,14.6
134,122,0,484,528,44,7.36,10.39,14.98
134,122,1,1032,1039,7,1.01,7.62,14.33
134,123,0,620,628,8,4.85,8.92,13.97
134,123,1,729,738,9,3.13,7.93,13.38
134,126,0,454,459,5,2.03,6.45,12.62
134,126,1,853,867,14,7.43,10.05,13.74
134,126,2,956,965,9,10.99,12.48,14.78
134,127,0,643,651,8,3.71,8.47,14.41
134,129,0,473,485,12,2.78,8,13.89
134,129,1,576,625,49,7.57,11.85,14.82
134,130,0,503,543,40,8.68,11.07,14.95
134,130,1,593,600,7,6.18,9.45,13.62
134,131,0,484,489,5,11.45,12.41,13.64
134,132,0,464,469,5,12.25,13.22,14.64
134,132,1,527,528,1,14.89,14.94,14.98
134,132,2,678,680,2,14.17,14.4,14.52
134,132,3,832,848,16,3.75,8.33,14.31
134,133,0,534,539,5,13.4,13.95,14.83
135,136,0,475,500,25,0.87,7.54,14.47
135,136,1,544,550,6,11.41,12.67,14.29
135,137,0,510,520,10,1.48,7.53,13.49
135,137,1,702,729,27,0.62,7.55,14.62
135,138,0,726,744,18,7.84,10.34,14.02
135,139,0,463,477,14,8.31,10.76,14.65
135,139,1,698,712,14,6.59,9.86,14.63
135,139,2,1011,1024,13,6.88,10.89,14.78
135,140,0,1024,1033,9,8.08,10.73,14.31
135,142,0,525,533,8,10.79,12.24,14.23
135,142,1,642,652,10,6.98,9.8,13.47
135,142,2,759,771,12,3.18,8.36,14.45
135,142,3,788,835,47,1.69,7.8,14.79
135,142,4,877,889,12,1.14,7.53,14.7
135,142,5,996,1007,11,4.71,8.64,13.59
135,143,0,488,496,8,11.28,12.59,14.62
135,144,0,594,596,2,14.4,14.56,14.7
135,145,0,518,524,6,12.04,13.16,14.55
135,146,0,463,478,15,7.34,9.76,14.66
135,148,0,724,760,36,3.22,8.2,14.32
135,148,1,781,806,25,5.37,9.12,14.34
135,149,0,970,983,13,9.88,11.79,14.66
136,135,0,437,450,13,4.54,8.59,13.88
136,135,1,475,500,25,0.87,7.54,14.47
136,135,2,544,550,6,11.41,12.67,14.29
136,137,0,505,509,4,11.31,12.41,13.76
136,137,1,658,663,5,9.4,11.09,13.14
136,137,2,964,971,7,2.41,7.97,14.44
136,138,0,588,609,21,1.09,7.27,14.59
136,138,1,983,995,12,1.35,7.48,14.28
136,139,0,437,451,14,3.88,8.65,14.96
136,139,1,470,481,11,4.98,8.62,14.27
136,139,2,561,566,5,10.4,11.8,13.48
136,139,3,723,738,15,4.73,8.97,14.75
136,140,0,842,850,8,11.35,12.32,14.3
136,140,1,1065,1066,1,13.27,13.9,14.52
136,141,0,579,581,2,13.67,14.02,14.48
136,142,0,512,519,7,5.62,9.21,13.89
136,142,1,592,597,5,11.34,12.73,14.85
136,143,0,488,494,6,9.34,11.34,13.67
136,143,1,984,991,7,8.3,10.97,14.5
136,144,0,634,639,5,8.82,10.65,12.81
136,144,1,925,932,7,0.67,7.59,14.55
136,145,0,678,690,12,7.44,9.94,14.13
136,145,1,962,971,9,5.44,9.37,14.82
136,146,0,451,457,6,7.33,10.23,14.21
136,146,1,891,897,6,7.07,10.05,13.7
136,146,2,966,968,2,14.46,14.78,14.96
136,147,0,537,547,10,1.39,7.72,14.55
136,147,1,726,735,9,13.35,13.95,14.95
136,147,2,742,752,10,1.41,7.78,14.52
136,148,0,531,539,8,8.37,10.84,14.6
136,148,1,843,849,6,11.16,12.42,14.53
137,135,0,510,520,10,1.48,7.53,13.49
137,135,1,702,729,27,0.62,7.55,14.62
137,136,0,505,509,4,11.31,12.41,13.76
137,136,1,658,663,5,9.4,11.09,13.14
137,136,2,964,971,7,2.41,7.97,14.44
137,138,0,547,560,13,1.18,7.53,14.23
137,138,1,721,732,11,6.32,9.91,14.94
137,138,2,870,886,16,3.99,8.93,14.92
137,138,3,925,941,16,8.79,11.15,14.95
137,139,0,702,713,11,0.93,7.73,14.65
137,139,1,1030,1037,7,0.4,7.48,14.57
137,141,0,467,480,13,6.35,9.55,14.85
137,141,1,616,618,2,14.64,14.72,14.76
137,141,2,885,888,3,12.8,13.26,13.76
137,141,3,1010,1021,11,8.79,11.05,14.4
137,142,0,1020,1022,2,13.98,14.23,14.36
137,143,0,546,554,8,6.08,9.54,13.69
137,143,1,639,645,6,10.55,12.21,14.74
137,144,0,861,868,7,4.6,8.76,13.52
137,144,1,1023,1024,1,14.6,14.78,14.96
137,145,0,468,477,9,5.71,10.04,14.53
137,145,1,530,544,14,13.84,14.21,14.82
137,145,2,878,887,9,7.94,10.92,14.88
137,145,3,954,981,27,8.34,10.86,14.94
137,146,0,963,1007,44,0.43,8.36,14.82
137,147,0,502,512,10,8.35,10.94,14.62
137,147,1,619,628,9,7.04,10.31,15
137,147,2,973,983,10,0.59,7.64,14.15
137,148,0,611,617,6,11.14,12.51,14.57
137,149,0,575,585,10,5.94,9.92,14.93
138,135,0,726,744,18,7.84,10.34,14.02
138,136,0,588,609,21,1.09,7.2,14.59
138,136,1,983,995,12,1.35,7.48,14.28
138,137,0,547,560,13,1.18,7.53,14.23
138,137,1,721,732,11,6.32,9.91,14.94
138,137,2,870,886,16,3.99,8.93,14.92
138,137,3,925,941,16,8.79,11.15,14.95
138,139,0,925,933,8,8.5,10.74,13.98
138,139,1,1041,1049,8,9.82,11.63,14.59
138,140,0,460,471,11,14.29,14.49,14.92
138,140,1,483,517,34,5.87,9.49,14.61
138,140,2,1044,1051,7,9.13,10.66,13.39
138,141,0,572,572,0,14.91,14.91,14.91
138,141,1,892,903,11,11.48,12.69,14.49
138,142,0,592,601,9,12.08,12.99,14.4
138,142,1,753,764,11,10.26,11.96,14.68
138,143,0,548,556,8,12.25,13.04,14.12
138,143,1,971,992,21,5.63,9.32,14.46
138,144,0,848,858,10,10.82,12.36,14.72
138,145,0,876,898,22,1.96,7.77,14.23
138,146,0,1020,1033,13,5.25,9.11,14.38
138,147,0,778,792,14,10.47,12.01,14.37
138,148,0,734,741,7,13.18,13.8,14.9
139,135,0,698,712,14,6.59,9.86,14.63
139,135,1,1011,1024,13,6.88,11.13,14.78
139,136,0,480,481,1,10.77,12.52,14.27
139,136,1,561,566,5,10.4,11.8,13.48
139,136,2,723,738,15,4.73,8.97,14.75
139,137,0,702,713,11,0.93,7.73,14.65
139,137,1,1030,1037,7,0.4,7.48,14.57
139,138,0,925,933,8,8.5,10.74,13.98
139,138,1,1041,1049,8,9.82,11.63,14.59
139,140,0,832,832,0,0.35,0.35,0.35
139,140,1,1063,1074,11,12.03,13.29,14.71
139,141,0,534,542,8,5.78,9.23,13.68
139,141,1,722,723,1,14.18,14.28,14.39
139,141,2,818,824,6,7.32,10.39,14.56
139,142,0,550,557,7,5.35,8.52,12.3
139,142,1,652,661,9,2.07,7.93,14.77
139,142,2,856,866,10,8.27,11.29,14.15
139,143,0,627,628,1,14.91,14.94,14.97
139,143,1,758,774,16,9.93,11.52,14.24
139,143,2,954,963,9,3.75,8.38,14.08
139,144,0,539,554,15,10.38,12.12,14.88
139,144,1,974,995,21,2.71,7.97,14.92
139,144,2,1046,1053,7,12.66,13.44,14.7
139,145,0,914,924,10,1.66,8.15,14.54
139,145,1,1050,1058,8,7.78,10.49,14.52
139,146,0,752,753,1,14.65,14.77,14.9
139,146,1,758,764,6,13.11,13.7,14.49
139,146,2,771,790,19,0.36,7.55,14.75
139,147,0,609,612,3,13.76,14.16,14.74
139,147,1,731,737,6,12.1,12.93,13.97
139,148,0,590,594,4,14.12,14.39,14.81
139,148,1,713,720,7,10.37,11.85,14.07
139,148,2,1035,1044,9,1.46,7.86,14.34
140,124,0,705,714,9,12.48,13.28,14.5
140,135,0,1024,1033,9,8.08,10.73,14.31
140,136,0,842,850,8,11.35,12.32,14.3
140,136,1,1065,1077,12,8.3,10.93,14.52
140,138,0,483,517,34,5.87,9.48,14.61
140,138,1,1044,1054,10,9.13,11.47,14.9
140,139,0,832,832,0,0.35,0.35,0.35
140,139,1,1063,1079,16,4.46,11.45,14.71
140,141,0,548,553,5,12.35,13.37,14.97
140,143,0,526,529,3,14.29,14.46,14.65
140,143,1,969,969,0,9.05,9.05,9.05
140,144,0,650,663,13,0.62,7.6,14.74
140,146,0,1039,1039,0,14.83,14.83,14.83
140,148,0,838,850,12,2.58,7.37,14.57
140,155,0,858,858,0,12.08,12.08,12.08
140,169,0,865,872,7,4.49,9.03,14.35
140,285,0,715,720,5,13.21,13.88,14.77
140,289,0,702,714,12,1.46,7.3,13.23
140,289,1,745,749,4,8.41,10.79,13.53
140,290,0,699,711,12,4.27,8.5,13.88
140,292,0,753,761,8,3.67,8.02,13.15
140,295,0,759,766,7,5.62,9.29,14.18
141,132,0,957,964,7,4.22,8.82,14.52
141,136,0,579,581,2,13.67,14.02,14.48
141,137,0,466,480,14,6.35,9.62,14.85
141,137,1,616,618,2,14.64,14.72,14.76
141,137,2,885,888,3,12.8,13.26,13.76
141,137,3,1010,1021,11,8.79,11.05,14.4
141,138,0,572,572,0,14.91,14.91,14.91
141,138,1,892,903,11,11.48,12.69,14.49
141,139,0,534,542,8,5.78,9.23,13.68
141,139,1,722,723,1,14.18,14.28,14.39
141,139,2,818,824,6,7.32,10.39,14.56
141,140,0,548,553,5,12.35,13.37,14.97
141,142,0,570,573,3,12.77,13.22,13.71
141,142,1,739,747,8,1.85,7.67,14.58
141,142,2,1024,1037,13,3.17,8.06,14.03
141,143,0,604,606,2,14.94,14.95,14.97
141,143,1,651,668,17,9.7,11.56,14.59
141,143,2,898,902,4,11.92,12.79,13.89
141,144,0,538,545,7,2.42,7.75,13.84
141,145,0,473,502,29,2.75,10.04,14.62
141,145,1,890,906,16,3.23,8.1,14
141,145,2,998,998,0,3.01,3.01,3.01
141,146,0,654,660,6,8.26,10.93,14.37
141,146,1,999,999,0,13.97,13.97,13.97
141,146,2,1004,1015,11,3.18,8.2,14.07
141,147,0,613,624,11,2.99,8.23,14.37
141,147,1,999,999,0,12.45,12.45,12.45
141,148,0,686,706,20,9.43,11.34,14.31
141,148,1,719,729,10,7.55,10.5,14.84
141,148,2,830,841,11,1.39,7.36,13.45
141,148,3,999,1019,20,3.3,7.23,14.17
141,195,0,916,916,0,13.7,13.7,13.7
141,196,0,923,932,9,14.1,14.41,14.96
141,198,0,987,989,2,8.8,11.39,14.02
141,201,0,918,928,10,2.45,6.87,13.44
141,206,0,983,988,5,10.36,11.94,13.86
142,135,0,525,533,8,10.79,12.24,14.23
142,135,1,642,652,10,6.98,9.8,13.47
142,135,2,759,771,12,3.18,8.36,14.45
142,135,3,788,835,47,1.69,7.8,14.79
142,135,4,877,889,12,1.14,7.53,14.7
142,135,5,996,1007,11,4.71,8.64,13.59
142,136,0,512,519,7,5.62,9.21,13.89
142,136,1,592,597,5,11.34,12.73,14.85
142,137,0,1020,1022,2,13.98,14.23,14.36
142,138,0,592,601,9,12.08,12.99,14.4
142,138,1,753,764,11,10.26,11.96,14.68
142,139,0,550,557,7,5.35,8.52,12.3
142,139,1,652,661,9,2.07,7.93,14.77
142,139,2,856,866,10,8.27,11.22,14.15
142,141,0,570,573,3,12.77,13.22,13.71
142,141,1,739,747,8,1.85,7.67,14.58
142,141,2,1024,1037,13,3.17,8.06,14.03
142,146,0,509,512,3,13.67,14.14,14.76
142,147,0,522,525,3,14.38,14.57,14.75
142,147,1,892,897,5,13.36,13.9,14.67
142,148,0,787,809,22,2.89,8.43,14.99
142,149,0,482,493,11,1.71,7.97,14.88
142,149,1,926,938,12,0.29,7.38,13.9
142,149,2,1045,1061,16,10.36,11.99,14.31
143,135,0,488,496,8,11.28,12.59,14.62
143,136,0,488,494,6,9.34,11.34,13.67
143,136,1,984,991,7,8.3,10.97,14.5
143,137,0,546,554,8,6.08,9.54,13.69
143,137,1,639,645,6,10.55,12.21,14.74
143,138,0,548,556,8,12.25,13.04,14.12
143,138,1,971,992,21,5.63,9.32,14.46
143,139,0,627,628,1,14.91,14.94,14.97
143,139,1,758,774,16,9.93,11.56,14.24
143,139,2,954,963,9,3.75,8.38,14.08
143,140,0,526,529,3,14.29,14.46,14.65
143,140,1,969,969,0,9.05,9.05,9.05
143,141,0,604,606,2,14.94,14.95,14.97
143,141,1,651,668,17,9.7,11.56,14.59
143,141,2,898,902,4,11.92,12.79,13.89
143,144,0,785,794,9,1.14,7.92,14.79
143,144,1,876,878,2,14.38,14.61,14.96
143,145,0,896,907,11,6.27,9.47,13.9
143,146,0,482,490,8,6.13,9.71,14.89
143,146,1,570,576,6,10.04,11.73,14.55
143,146,2,659,662,3,13.96,14.38,14.94
143,146,3,743,751,8,4.99,9.06,13.85
143,147,0,610,617,7,12.75,13.58,14.75
143,147,1,686,698,12,13.35,13.91,14.93
143,147,2,1004,1016,12,4.45,8.83,14.8
143,149,0,676,687,11,2.44,7.99,14.61
144,135,0,594,596,2,14.4,14.56,14.7
144,136,0,634,639,5,8.82,10.65,12.81
144,136,1,925,932,7,0.67,7.59,14.55
144,137,0,454,466,12,7.21,9.75,13.61
144,137,1,861,868,7,4.6,8.76,13.52
144,137,2,1023,1024,1,14.6,14.78,14.96
144,138,0,848,858,10,10.82,12.36,14.72
144,139,0,539,554,15,10.38,12.12,14.88
144,139,1,974,995,21,2.71,7.85,14.92
144,140,0,650,663,13,0.62,7.6,14.74
144,141,0,538,545,7,2.42,7.75,13.84
144,143,0,785,794,9,1.14,7.92,14.79
144,143,1,876,878,2,14.38,14.61,14.96
144,146,0,866,871,5,10.22,11.9,14.59
144,146,1,941,949,8,0.87,8.08,14.98
144,146,2,1019,1025,6,9.13,11.44,14.86
144,147,0,480,487,7,11.73,12.99,14.84
144,147,1,697,707,10,0.67,7.47,13.71
144,148,0,473,479,6,11.94,12.94,14.48
144,148,1,873,889,16,0.18,7.24,13.77
144,148,2,1021,1032,11,1.14,7.62,14.18
145,15,0,776,785,9,7.74,10.23,13.61
145,19,0,724,724,0,12.76,12.76,12.76
145,19,1,740,765,25,5.78,9.47,14.43
145,22,0,773,777,4,13.38,13.97,14.63
145,24,0,761,769,8,8.39,10.96,14.59
145,28,0,771,795,24,3.49,8.48,14.99
145,48,0,843,853,10,11.53,12.66,14.73
145,50,0,608,608,0,14.57,14.57,14.57
145,50,1,612,658,46,5,9.07,14.93
145,112,0,777,798,21,6.44,9.87,14.78
145,135,0,518,524,6,12.04,13.16,14.55
145,136,0,678,690,12,7.44,9.94,14.13
145,136,1,962,971,9,5.44,9.37,14.82
145,137,0,468,477,9,5.71,9.95,14.53
145,137,1,530,544,14,13.84,14.21,14.82
145,137,2,878,887,9,7.94,10.92,14.88
145,137,3,954,981,27,8.34,10.86,14.94
145,138,0,876,898,22,1.96,7.77,14.23
145,139,0,914,924,10,1.66,8.15,14.54
145,139,1,1050,1058,8,7.78,10.49,14.52
145,141,0,473,502,29,2.75,9.96,14.62
145,141,1,890,906,16,3.23,8.1,14
145,141,2,998,998,0,3.01,3.01,3.01
145,143,0,433,439,6,13.31,13.89,14.8
145,143,1,896,907,11,6.27,9.47,13.9
145,144,0,1046,1058,12,8.01,10.51,14.28
145,147,0,977,990,13,8.21,10.92,14.95
145,148,0,494,504,10,10.52,12.27,14.94
145,148,1,969,986,17,5.19,9.21,14.75
145,149,0,587,587,0,12.91,12.91,12.91
145,149,1,710,714,4,13.38,13.75,14.43
146,135,0,458,478,20,7.34,10.07,14.66
146,136,0,451,457,6,7.33,10.23,14.21
146,136,1,891,897,6,7.07,10.05,13.7
146,136,2,966,968,2,14.46,14.78,14.96
146,137,0,963,1007,44,0.43,8.35,14.82
146,138,0,1020,1033,13,5.25,9.11,14.38
146,139,0,462,466,4,14.22,14.45,14.69
146,139,1,752,753,1,14.65,14.77,14.9
146,139,2,758,764,6,13.11,13.7,14.49
146,139,3,771,790,19,0.36,7.55,14.75
146,140,0,1039,1039,0,14.83,14.83,14.83
146,141,0,654,660,6,8.26,10.93,14.37
146,141,1,999,999,0,13.97,13.97,13.97
146,141,2,1004,1015,11,3.18,8.2,14.07
146,142,0,509,512,3,13.67,14.14,14.76
146,143,0,482,490,8,6.13,9.71,14.89
146,143,1,570,576,6,10.04,11.73,14.55
146,143,2,659,662,3,13.96,14.38,14.94
146,143,3,743,751,8,4.99,9.06,13.85
146,144,0,866,871,5,10.22,11.9,14.59
146,144,1,941,949,8,0.87,8.08,14.98
146,144,2,1019,1025,6,9.13,11.44,14.86
146,147,0,645,649,4,13.18,13.64,14.24
146,147,1,972,982,10,4.13,8.65,14.99
146,148,0,636,646,10,1.5,7.72,13.94
146,148,1,862,869,7,10.72,12.34,14.9
146,148,2,1001,1023,22,0.47,7.37,14.39
146,149,0,502,511,9,1.19,7.09,13.05
146,149,1,576,605,29,11.43,12.82,14.87
147,136,0,537,547,10,1.39,7.72,14.55
147,136,1,726,735,9,13.35,13.95,14.95
147,136,2,742,752,10,1.41,7.78,14.52
147,137,0,502,512,10,8.35,10.94,14.62
147,137,1,619,628,9,7.04,10.31,15
147,137,2,973,983,10,0.59,7.64,14.15
147,138,0,778,792,14,10.47,12.01,14.37
147,139,0,609,612,3,13.76,14.16,14.74
147,139,1,731,737,6,12.1,12.93,13.97
147,141,0,613,624,11,2.99,8.23,14.37
147,141,1,999,999,0,12.45,12.45,12.45
147,142,0,522,525,3,14.38,14.57,14.75
147,142,1,892,897,5,13.36,13.9,14.67
147,143,0,610,617,7,12.75,13.58,14.75
147,143,1,686,698,12,13.35,13.91,14.93
147,143,2,1004,1016,12,4.45,8.83,14.8
147,144,0,480,487,7,11.73,12.99,14.84
147,144,1,697,707,10,0.67,7.47,13.71
147,145,0,977,990,13,8.21,10.92,14.95
147,146,0,645,649,4,13.18,13.64,14.24
147,146,1,972,982,10,4.13,8.65,14.99
147,148,0,549,569,20,1.31,7.64,14.25
147,148,1,805,817,12,11.51,12.81,14.86
147,148,2,981,998,17,5.86,9.46,14.67
147,149,0,663,679,16,1.55,7.78,14.59
148,135,0,724,760,36,3.22,8.16,14.32
148,135,1,781,806,25,5.37,9.12,14.34
148,136,0,531,539,8,8.37,10.84,14.6
148,136,1,843,849,6,11.16,12.42,14.53
148,137,0,611,617,6,11.14,12.51,14.57
148,137,1,1049,1066,17,5.34,8.5,14.9
148,138,0,734,741,7,13.18,13.8,14.9
148,139,0,590,594,4,14.12,14.39,14.81
148,139,1,713,720,7,10.37,11.85,14.07
148,139,2,1035,1044,9,1.46,7.86,14.34
148,140,0,838,850,12,2.58,7.37,14.57
148,141,0,686,706,20,9.43,11.34,14.31
148,141,1,719,729,10,7.55,10.5,14.84
148,141,2,830,841,11,1.39,7.36,13.45
148,141,3,999,1019,20,3.3,7.23,14.17
148,142,0,787,809,22,2.89,8.43,14.99
148,144,0,473,479,6,11.94,12.94,14.48
148,144,1,873,889,16,0.18,7.24,13.77
148,144,2,1021,1032,11,1.14,7.62,14.18
148,145,0,494,504,10,10.52,12.27,14.94
148,145,1,969,986,17,5.19,9.21,14.75
148,146,0,636,646,10,1.5,7.72,13.94
148,146,1,862,869,7,10.72,12.34,14.9
148,146,2,1001,1023,22,0.47,7.37,14.39
148,147,0,436,454,18,1.83,6.62,14.47
148,147,1,549,569,20,1.31,7.64,14.25
148,147,2,805,817,12,11.51,12.81,14.86
148,147,3,981,998,17,5.86,9.46,14.67
149,135,0,970,983,13,9.88,11.79,14.66
149,137,0,575,585,10,5.94,9.92,14.93
149,142,0,482,493,11,1.71,7.97,14.88
149,142,1,926,938,12,0.29,7.38,13.9
149,143,0,676,687,11,2.44,7.99,14.61
149,145,0,587,587,0,12.91,12.91,12.91
149,145,1,710,714,4,13.38,13.75,14.43
149,146,0,502,511,9,1.19,7.09,13.05
149,146,1,576,605,29,11.43,12.75,14.74
149,147,0,663,679,16,1.55,7.78,14.59
149,155,0,805,810,5,13.48,14.02,14.81
150,151,0,638,673,35,3.39,9.82,14.89
150,152,0,669,700,31,1.2,7.65,14.67
150,153,0,613,619,6,9.81,11.98,14.57
150,153,1,690,695,5,11.31,12.7,14.51
150,156,0,492,499,7,8.02,10.43,13.68
150,156,1,580,588,8,2.79,7.63,12.64
150,156,2,945,950,5,10.69,12.3,13.97
150,157,0,543,552,9,2.01,7.46,13.48
150,157,1,773,776,3,5.03,8.87,12.79
150,158,0,714,724,10,1.16,7.9,14.66
150,159,0,642,658,16,10.15,11.76,14.21
150,159,1,1014,1030,16,5.01,9.04,14.55
150,160,0,609,615,6,9.31,11.06,13.2
150,162,0,643,646,3,13.66,14,14.37
150,162,1,699,705,6,14.17,14.41,14.77
150,164,0,581,588,7,8.32,10.73,13.81
150,164,1,755,763,8,0.46,7.03,12.91
151,150,0,638,673,35,3.39,9.82,14.89
151,152,0,942,974,32,0.51,8.39,14.68
151,153,0,440,475,35,2.5,9.94,14.88
151,155,0,550,563,13,10.32,12.06,14.99
151,155,1,901,936,35,1.01,7.01,14.14
151,158,0,782,820,38,6.33,9.37,14.96
151,158,1,975,996,21,1.15,7.84,14.8
151,159,0,566,638,72,2.57,8.2,14.93
151,160,0,807,822,15,8.68,11.16,14.96
151,161,0,895,930,35,0.27,7.81,14.33
151,163,0,457,465,8,13.29,13.98,14.95
151,163,1,972,980,8,13.13,13.77,14.86
152,150,0,669,700,31,1.2,7.65,14.67
152,151,0,942,974,32,0.51,8.27,14.68
152,153,0,690,699,9,4.01,8.65,14.04
152,155,0,713,721,8,9.04,11.14,13.86
152,155,1,882,904,22,4.61,8.81,14.51
152,155,2,933,942,9,9.85,11.71,14.42
152,157,0,477,484,7,2.48,7.69,14.25
152,158,0,969,981,12,2.78,7.95,13.73
152,161,0,876,901,25,1.31,7.66,14.67
152,161,1,928,937,9,9.76,11.83,14.95
152,162,0,545,557,12,9.04,11.4,14.72
152,162,1,623,635,12,4.62,8.73,14.14
152,163,0,569,601,32,2.05,7.92,14.89
152,164,0,880,891,11,4.21,8.96,14.71
152,164,1,989,996,7,10.49,12.04,14.1
153,150,0,613,619,6,9.81,11.98,14.57
153,150,1,690,695,5,11.31,12.7,14.51
153,151,0,466,475,9,2.5,6.73,13.61
153,152,0,690,699,9,4.01,8.65,14.04
153,154,0,568,573,5,13.54,14.09,14.89
153,155,0,1002,1008,6,11.12,12.24,13.67
153,156,0,628,633,5,11.16,12.55,14.46
153,156,1,1000,1004,4,12.29,13.31,14.78
153,157,0,517,533,16,4.1,8.86,14.96
153,157,1,742,761,19,1.81,9.11,14.5
153,158,0,494,500,6,10.6,12.32,14.97
153,158,1,580,583,3,13.18,13.64,14.24
153,158,2,664,670,6,11.27,12.96,14.95
153,159,0,556,562,6,13.87,14.25,14.74
153,159,1,1045,1053,8,1.82,6.55,13.48
153,160,0,478,479,1,14.62,14.79,14.96
153,160,1,570,573,3,13.57,14.13,14.96
153,160,2,619,630,11,8.02,10.49,14.23
153,160,3,921,928,7,9.49,11.67,14.56
153,160,4,934,935,1,11.85,12.63,13.42
153,161,0,626,634,8,9,11.09,13.98
153,161,1,829,838,9,10.62,12.24,14.69
153,161,2,988,1000,12,4.24,8.86,13.73
153,162,0,503,511,8,1.97,7.96,14.14
153,162,1,683,691,8,2.77,8.22,14.94
153,162,2,864,872,8,5.49,9.77,14.67
153,162,3,1045,1051,6,9.72,11.71,14.77
153,164,0,474,477,3,13.82,14.31,14.9
153,164,1,549,556,7,3.25,8.07,13.99
153,164,2,703,711,8,1.59,8.28,14.69
154,153,0,568,573,5,13.54,14.09,14.89
154,155,0,428,446,18,9.05,12.04,14.54
154,156,0,734,757,23,3.45,8.21,14.31
154,156,1,809,819,10,9.89,11.31,13.76
154,158,0,892,903,11,13.76,14.15,14.77
154,158,1,910,924,14,9.47,11.48,14.59
154,160,0,564,576,12,4.65,8.53,13.35
154,161,0,704,705,1,14.98,14.98,14.98
154,162,0,790,803,13,3.78,8.48,14.71
154,162,1,986,1000,14,6.98,9.98,14.52
154,163,0,883,920,37,0.65,8.4,14.91
154,164,0,514,528,14,10.47,12.02,14.57
155,140,0,858,858,0,12.08,12.08,12.08
155,149,0,805,810,5,13.48,14.02,14.81
155,150,0,435,436,1,11.33,12.25,13.17
155,151,0,550,563,13,10.32,12.06,14.99
155,151,1,901,936,35,1.01,7.12,14.14
155,152,0,713,721,8,9.04,11.14,13.86
155,152,1,882,904,22,4.61,8.81,14.51
155,152,2,933,942,9,9.85,11.71,14.42
155,153,0,1002,1008,6,11.12,12.24,13.67
155,154,0,435,446,11,9.05,10.91,14.54
155,156,0,752,767,15,0.55,7.66,14.8
155,156,1,986,1007,21,6.02,9.4,14.28
155,156,2,1020,1034,14,11.2,12.62,14.79
155,157,0,594,617,23,4.86,8.9,14.45
155,157,1,975,981,6,11.46,12.87,14.99
155,158,0,541,554,13,0.57,7.44,14.3
155,158,1,723,736,13,5.26,9.47,14.88
155,159,0,545,562,17,8.56,11.05,14.86
155,159,1,572,579,7,8.96,10.73,13.08
155,160,0,508,511,3,12.98,13.69,14.72
155,160,1,581,588,7,5.28,9.29,14
155,161,0,678,685,7,7.58,10.63,14.79
155,161,1,876,960,84,3.39,9.51,14.86
155,162,0,691,699,8,2.01,7.9,14.01
155,162,1,776,780,4,4.59,7.31,11.78
155,164,0,537,545,8,12.06,13.09,14.86
155,164,1,875,875,0,14.51,14.51,14.51
155,164,2,879,892,13,6.79,10.06,14.69
156,150,0,492,499,7,8.02,10.43,13.68
156,150,1,580,588,8,2.79,7.63,12.64
156,150,2,945,950,5,10.69,12.3,13.97
156,153,0,628,633,5,11.16,12.55,14.46
156,153,1,1000,1004,4,12.29,13.31,14.78
156,154,0,734,757,23,3.45,8.21,14.31
156,154,1,809,819,10,9.89,11.31,13.76
156,155,0,752,767,15,0.55,7.66,14.8
156,155,1,986,1007,21,6.02,9.4,14.28
156,155,2,1020,1034,14,11.2,12.62,14.79
156,157,0,562,573,11,3.4,8.48,14.86
156,157,1,695,706,11,9.93,11.91,14.8
156,157,2,974,978,4,12.81,13.5,14.2
156,159,0,679,721,42,3.15,8.17,14.29
156,160,0,444,454,10,4.52,7.88,13.75
156,160,1,626,635,9,4.07,8.56,14.54
156,161,0,618,628,10,9.05,11.39,14.64
156,161,1,999,1027,28,0.92,9.28,14.97
156,162,0,948,954,6,5.8,9.05,12.85
156,164,0,573,609,36,0.44,7.43,14.49
157,150,0,543,552,9,2.01,7.46,13.48
157,150,1,773,776,3,5.03,8.87,12.79
157,152,0,480,484,4,6.28,10.24,14.25
157,153,0,517,533,16,4.1,8.86,14.96
157,153,1,742,761,19,1.81,9.39,14.57
157,155,0,594,617,23,4.86,8.9,14.45
157,155,1,975,981,6,11.46,12.87,14.99
157,156,0,562,573,11,3.4,8.48,14.86
157,156,1,695,706,11,9.93,11.91,14.8
157,156,2,974,978,4,12.81,13.5,14.2
157,158,0,1004,1017,13,1.38,7.01,13.24
157,159,0,692,705,13,1.06,7.64,14.22
157,159,1,880,899,19,3.28,8.18,14.31
157,160,0,884,898,14,2.81,7.85,13.61
157,161,0,506,515,9,6.27,10.09,14.92
157,162,0,514,516,2,14.48,14.66,14.89
157,163,0,1003,1013,10,1.16,7.63,14.95
157,163,1,1043,1050,7,3.86,9.28,14.89
158,150,0,714,724,10,1.16,7.9,14.66
158,151,0,782,820,38,6.33,9.44,14.96
158,151,1,975,996,21,1.15,7.84,14.8
158,152,0,969,981,12,2.78,7.95,13.73
158,153,0,494,500,6,10.6,12.32,14.97
158,153,1,580,583,3,13.18,13.64,14.24
158,153,2,664,670,6,11.27,12.96,14.95
158,154,0,892,903,11,13.76,14.15,14.77
158,154,1,910,924,14,9.47,11.48,14.59
158,155,0,541,554,13,0.57,7.44,14.3
158,155,1,723,736,13,5.26,9.47,14.88
158,157,0,1004,1018,14,1.38,7.48,14.03
158,159,0,426,436,10,2.5,7.59,13.72
158,159,1,516,550,34,0.74,7.49,14.43
158,159,2,601,607,6,13.49,14.08,14.9
158,159,3,858,862,4,14.55,14.68,14.87
158,160,0,735,745,10,9.55,11.56,14.39
158,160,1,802,825,23,0.75,7.58,14.51
158,160,2,865,874,9,9.62,11.27,13.62
158,161,0,642,658,16,2.15,7.93,14.7
158,163,0,497,499,2,14.53,14.7,14.99
158,163,1,893,938,45,3.03,8.3,14.89
158,163,2,1005,1014,9,4.19,8.15,12.85
158,163,3,1029,1048,19,6.92,9.97,14.47
158,164,0,430,443,13,11.8,12.9,14.63
158,164,1,536,546,10,1.28,7.85,14.79
158,164,2,635,644,9,4.93,8.99,13.6
158,164,3,734,739,5,12.7,13.53,14.74
159,150,0,642,659,17,10.15,11.88,14.84
159,150,1,1014,1030,16,5.01,9.04,14.55
159,151,0,566,638,72,2.57,8.21,14.93
159,153,0,556,562,6,13.87,14.25,14.74
159,155,0,545,562,17,8.56,11.05,14.86
159,155,1,572,579,7,8.96,10.73,13.08
159,156,0,679,721,42,3.15,8.17,14.29
159,157,0,692,705,13,1.06,7.64,14.22
159,157,1,880,899,19,3.28,8.18,14.31
159,158,0,516,550,34,0.74,7.49,14.43
159,158,1,601,607,6,13.49,14.08,14.9
159,158,2,858,862,4,14.55,14.68,14.87
159,160,0,482,488,6,12.04,12.99,14.5
159,160,1,878,902,24,0.84,7.41,14.3
159,163,0,481,493,12,6.6,9.85,14.2
159,163,1,769,783,14,0.26,7.29,13.88
159,164,0,538,551,13,3.74,8.28,13.84
160,83,0,973,994,21,4.02,8.79,14.96
160,150,0,609,615,6,9.31,11.06,13.2
160,151,0,807,822,15,8.68,11.16,14.96
160,153,0,478,479,1,14.62,14.79,14.96
160,153,1,570,573,3,13.57,14.13,14.96
160,153,2,619,630,11,8.02,10.49,14.23
160,153,3,921,928,7,9.49,11.86,14.56
160,153,4,934,935,1,11.85,12.63,13.42
160,154,0,564,576,12,4.65,8.53,13.35
160,155,0,508,511,3,12.98,13.69,14.72
160,155,1,581,588,7,5.28,9.29,14
160,156,0,626,635,9,4.07,8.56,14.54
160,157,0,884,898,14,2.81,7.85,13.61
160,158,0,735,745,10,9.55,11.56,14.39
160,158,1,802,825,23,0.75,7.58,14.51
160,158,2,865,874,9,9.62,11.27,13.62
160,159,0,482,488,6,12.04,12.99,14.5
160,159,1,878,902,24,0.84,7.41,14.3
160,161,0,622,627,5,11.12,12.42,14.02
160,163,0,477,486,9,2.19,7.8,14.18
160,163,1,694,703,9,4.89,9.46,14.83
160,163,2,842,860,18,3.08,7.34,14.07
161,151,0,895,930,35,0.27,7.95,14.33
161,152,0,876,901,25,1.31,7.66,14.67
161,152,1,928,937,9,9.76,11.83,14.95
161,153,0,626,634,8,9,11.09,13.98
161,153,1,829,838,9,10.62,12.24,14.69
161,153,2,988,1000,12,4.24,8.64,13.73
161,154,0,704,705,1,14.98,14.98,14.98
161,155,0,678,685,7,7.58,10.63,14.79
161,155,1,876,960,84,3.39,9.49,14.86
161,156,0,618,628,10,9.05,11.39,14.64
161,156,1,999,1027,28,0.92,9.19,14.97
161,157,0,506,515,9,6.27,10.09,14.92
161,158,0,642,658,16,2.15,8.02,14.7
161,160,0,622,627,5,11.12,12.42,14.02
161,162,0,480,504,24,12.13,13.68,14.95
161,162,1,846,853,7,9.38,11.35,14.03
161,163,0,510,523,13,3.02,8.27,14.49
161,164,0,629,636,7,13.2,13.74,14.49
161,164,1,878,892,14,0.25,7.95,14.94
162,150,0,643,646,3,13.66,14,14.37
162,150,1,699,705,6,14.17,14.41,14.77
162,152,0,545,557,12,9.04,11.4,14.72
162,152,1,623,635,12,4.62,8.73,14.14
162,153,0,503,511,8,1.97,7.96,14.14
162,153,1,683,691,8,2.77,8.22,14.94
162,153,2,864,872,8,5.49,9.77,14.67
162,153,3,1045,1051,6,9.72,11.71,14.77
162,154,0,790,803,13,3.78,8.48,14.71
162,154,1,986,1000,14,6.98,9.98,14.52
162,155,0,691,699,8,2.01,7.9,14.01
162,155,1,776,780,4,4.59,7.31,11.78
162,156,0,948,954,6,5.8,9.05,12.85
162,157,0,514,516,2,14.48,14.66,14.89
162,159,0,1048,1049,1,14.9,14.93,14.96
162,161,0,480,504,24,12.13,13.73,14.95
162,161,1,846,853,7,9.38,11.35,14.03
162,163,0,596,612,16,6.81,9.92,14.21
162,164,0,661,666,5,10.96,12.07,13.49
162,164,1,820,836,16,0.79,7.63,14.49
162,164,2,970,978,8,9.84,12.05,14.89
163,151,0,457,465,8,13.29,13.98,14.95
163,151,1,972,980,8,13.13,13.77,14.86
163,152,0,569,601,32,2.05,7.92,14.89
163,153,0,451,463,12,11.87,13.01,14.82
163,154,0,883,920,37,0.65,8.55,14.91
163,157,0,1003,1013,10,1.16,7.63,14.95
163,158,0,497,499,2,14.53,14.7,14.99
163,158,1,893,938,45,3.03,8.31,14.89
163,158,2,1005,1014,9,4.19,8.15,12.85
163,159,0,481,493,12,6.6,9.85,14.2
163,159,1,769,783,14,0.26,7.29,13.88
163,160,0,477,486,9,2.19,7.8,14.18
163,160,1,694,703,9,4.89,9.46,14.83
163,160,2,841,860,19,3.08,7.84,14.07
163,161,0,510,523,13,3.02,8.27,14.49
163,162,0,596,612,16,6.81,9.92,14.21
163,164,0,469,478,9,2.32,7.99,14.04
164,150,0,581,588,7,8.32,10.73,13.81
164,150,1,755,763,8,0.46,7.03,12.91
164,152,0,880,891,11,4.21,8.96,14.71
164,152,1,989,996,7,10.49,12.04,14.1
164,153,0,474,477,3,13.82,14.31,14.9
164,153,1,549,556,7,3.25,8.07,13.99
164,153,2,703,711,8,1.59,8.28,14.69
164,154,0,514,528,14,10.47,12.02,14.57
164,155,0,537,545,8,12.06,13.09,14.86
164,155,1,875,875,0,14.51,14.51,14.51
164,155,2,879,892,13,6.79,10.06,14.69
164,156,0,573,609,36,0.44,7.41,14.49
164,158,0,536,546,10,1.28,7.85,14.79
164,158,1,635,644,9,4.93,8.97,13.6
164,158,2,734,739,5,12.7,13.53,14.74
164,159,0,538,551,13,3.74,8.28,13.84
164,161,0,629,636,7,13.2,13.74,14.49
164,161,1,878,892,14,0.25,7.95,14.94
164,162,0,661,666,5,10.96,12.07,13.49
164,162,1,820,836,16,0.79,7.63,14.49
164,162,2,970,978,8,9.84,12.05,14.89
164,163,0,469,478,9,2.32,7.99,14.04
165,166,0,486,490,4,12.71,13.47,14.62
165,166,1,586,593,7,9.41,11.39,13.99
165,166,2,647,665,18,1.35,7.73,14.49
165,167,0,678,688,10,1.88,8.09,14.26
165,167,1,896,905,9,6.13,9.75,14.82
165,167,2,1005,1012,7,8.4,10.81,14.3
165,168,0,451,458,7,7.05,10.36,14.23
165,169,0,646,659,13,4.89,8.9,14.49
165,169,1,973,973,0,13.4,13.4,13.4
165,170,0,682,732,50,4.31,8.79,14.72
165,171,0,627,635,8,10.21,12.02,14.4
165,172,0,451,465,14,9.8,11.38,14.92
165,172,1,559,566,7,6.06,9.04,12.69
165,175,0,894,903,9,7.18,9.96,13.62
165,176,0,713,722,9,6.41,9.89,14.81
165,176,1,976,976,0,8.51,8.51,8.51
165,177,0,521,530,9,2.03,7.65,13.55
165,177,1,813,820,7,9.78,11.71,14.3
165,177,2,909,967,58,3.69,7.72,14.62
165,178,0,588,597,9,6.22,9.69,14.22
165,179,0,454,469,15,10.02,11.57,14.41
165,179,1,716,722,6,12.21,13.14,14.7
165,179,2,964,973,9,8.12,10.58,14.3
166,165,0,486,490,4,12.71,13.47,14.62
166,165,1,586,593,7,9.41,11.39,13.99
166,165,2,647,665,18,1.35,7.73,14.49
166,167,0,666,670,4,13.79,14.36,14.98
166,167,1,760,766,6,10.82,12.18,13.84
166,167,2,973,982,9,7.71,10.78,14.87
166,168,0,691,698,7,11.12,12.71,14.95
166,168,1,909,919,10,0.86,7.72,14.6
166,169,0,647,658,11,0.46,7.67,14.88
166,169,1,1032,1043,11,4.24,7.97,12.89
166,171,0,927,934,7,7.22,10.27,14.35
166,171,1,1024,1029,5,12.88,13.69,14.72
166,172,0,475,479,4,12.13,13.35,14.87
166,172,1,937,971,34,0.74,9.8,14.92
166,173,0,885,891,6,11.35,12.57,14.3
166,174,0,455,463,8,2.12,8,14.15
166,174,1,735,749,14,3.09,8.31,14.51
166,174,2,829,838,9,1.19,7.8,14.41
166,174,3,1018,1028,10,3.73,8.83,14.04
166,175,0,459,491,32,0.71,7.71,14.93
166,175,1,513,520,7,5.99,10.06,14.9
166,175,2,863,870,7,6.74,10.08,13.91
166,175,3,984,989,5,12.82,13.43,14.34
166,176,0,564,570,6,11.45,12.63,14.23
166,177,0,711,713,2,13.48,13.8,14.03
166,178,0,531,537,6,10.93,12.32,14.25
166,178,1,548,612,64,2.36,8.74,14.8
166,179,0,507,511,4,12.32,13.24,14.94
167,165,0,678,688,10,1.88,8.09,14.26
167,165,1,896,905,9,6.13,9.75,14.82
167,165,2,1005,1012,7,8.4,10.81,14.3
167,166,0,666,670,4,13.79,14.36,14.98
167,166,1,760,766,6,10.82,12.18,13.84
167,166,2,973,982,9,7.71,10.78,14.87
167,168,0,478,488,10,9.11,10.57,13.84
167,168,1,1023,1029,6,13.24,13.81,14.67
167,169,0,501,511,10,5.72,9.41,14.97
167,170,0,645,686,41,6.37,9.7,14.89
167,170,1,700,705,5,12.42,13.21,14.4
167,170,2,804,811,7,4.96,8.61,13.04
167,172,0,478,492,14,11.72,13.17,14.81
167,172,1,555,555,0,14.87,14.87,14.87
167,173,0,535,536,1,14.76,14.88,15
167,174,0,586,590,4,12.21,13.19,14.86
167,175,0,885,894,9,11.47,12.83,14.91
167,175,1,898,952,54,1.67,7.76,14.73
167,176,0,586,597,11,4.64,8.51,13.45
167,177,0,613,620,7,1.9,7.3,12.86
167,177,1,987,999,12,1.66,7.48,13.58
167,178,0,1022,1029,7,8.9,10.95,13.73
167,179,0,702,706,4,10.98,12.1,13.39
168,165,0,442,458,16,6.55,10.47,14.92
168,166,0,691,698,7,11.12,12.71,14.95
168,166,1,909,919,10,0.86,7.72,14.6
168,167,0,458,488,30,5.82,9.5,14.64
168,167,1,1023,1025,2,13.41,13.93,14.67
168,170,0,732,736,4,13.82,14.21,14.81
168,171,0,820,846,26,0.68,7.77,14.89
168,172,0,454,480,26,7.21,9.8,14.37
168,172,1,626,640,14,7.05,11.34,14.93
168,172,2,883,892,9,13.04,13.7,14.88
168,173,0,638,679,41,1,7.9,14.2
168,175,0,1010,1016,6,10.31,11.93,14.08
168,176,0,511,516,5,12.11,13.03,14.48
168,176,1,724,733,9,3.79,8.27,13.64
168,178,0,973,1000,27,9.88,12.15,15
168,179,0,547,552,5,11.58,12.76,14.69
168,179,1,813,820,7,9.69,11.86,14.96
168,179,2,901,909,8,2.38,7.57,12.69
168,179,3,990,1025,35,4.97,8.4,12.97
169,140,0,865,872,7,4.49,9.03,14.35
169,165,0,646,659,13,4.89,8.9,14.49
169,165,1,973,973,0,13.4,13.4,13.4
169,166,0,647,658,11,0.46,7.67,14.88
169,166,1,1032,1043,11,4.24,8.24,12.89
169,167,0,501,511,10,5.72,9.41,14.97
169,170,0,449,462,13,6.17,9.56,14.75
169,171,0,1054,1069,15,1.18,7.38,13.8
169,173,0,713,728,15,6.82,9.93,14.56
169,173,1,756,767,11,1.06,7.62,14.48
169,174,0,473,487,14,1.5,7.83,14.95
169,174,1,1055,1071,16,0.86,7.82,14.61
169,175,0,742,748,6,12.82,13.62,14.84
169,176,0,518,529,11,6.58,9.61,13.88
169,176,1,679,691,12,0.34,7.23,13.57
169,176,2,975,975,0,3.74,3.74,3.74
169,177,0,449,458,9,7.5,10,14.47
169,177,1,806,816,10,7.03,10.01,14.31
169,179,0,548,561,13,0.76,7.61,14.59
169,179,1,973,973,0,11.74,11.74,11.74
169,179,2,978,991,13,4.94,8.73,13.74
169,317,0,904,907,3,13.83,14.17,14.58
169,330,0,891,897,6,12.25,13.15,14.25
170,165,0,682,732,50,4.31,8.85,14.72
170,166,0,429,440,11,12.27,13.11,14.49
170,167,0,645,686,41,6.37,9.71,14.89
170,167,1,700,705,5,12.42,13.21,14.4
170,167,2,804,811,7,4.96,8.61,13.04
170,168,0,732,736,4,13.82,14.21,14.81
170,169,0,448,462,14,6.17,9.9,14.76
170,171,0,739,751,12,3.7,8.09,13.28
170,171,1,1009,1021,12,6.9,9.45,13.47
170,173,0,616,626,10,2.29,7.7,13.76
170,173,1,784,793,9,10.09,11.81,14.35
170,174,0,537,558,21,3.97,8.74,14.99
170,174,1,776,781,5,12.66,13.6,14.94
170,174,2,979,986,7,7.87,10.19,13.3
170,175,0,443,446,3,13.18,13.62,14.1
170,175,1,768,780,12,9.69,11.62,14.88
170,176,0,717,723,6,13.16,13.66,14.27
170,177,0,439,454,15,1.12,7.65,14.83
170,177,1,491,496,5,13.26,13.89,14.86
170,177,2,601,610,9,1.39,7.54,14.09
170,178,0,558,564,6,9.97,11.91,14.97
170,178,1,760,767,7,11.33,12.82,14.93
171,165,0,627,635,8,10.21,12.02,14.4
171,166,0,927,934,7,7.22,10.27,14.35
171,166,1,1024,1029,5,12.88,13.69,14.72
171,168,0,820,846,26,0.68,7.77,14.89
171,170,0,739,751,12,3.7,8.09,13.28
171,170,1,1009,1023,14,6.9,9.9,14.73
171,172,0,915,927,12,4.64,9.14,14.63
171,173,0,720,724,4,12.37,13.24,14.36
171,174,0,663,672,9,5.45,9.34,14.59
171,174,1,1022,1030,8,3.32,8.8,14.65
171,175,0,612,620,8,9.61,11.54,14.45
171,175,1,828,830,2,14.33,14.57,14.92
171,177,0,554,575,21,2.66,8.02,14.57
171,177,1,763,766,3,13.79,14.25,14.95
171,178,0,525,532,7,7.91,10.69,14.39
171,178,1,641,647,6,9.22,11.26,14.11
171,179,0,595,603,8,6.87,9.75,13.46
171,179,1,935,949,14,4.16,8.5,14.32
172,29,0,731,751,20,7.64,10.08,14.88
172,29,1,772,782,10,5.45,8.95,13.21
172,48,0,797,803,6,12.83,13.63,14.99
172,112,0,730,730,0,12.6,12.6,12.6
172,165,0,559,566,7,6.06,9.04,12.69
172,166,0,475,479,4,12.13,13.35,14.87
172,166,1,937,971,34,0.74,9.79,14.92
172,167,0,470,492,22,4.44,11,14.81
172,167,1,555,555,0,14.87,14.87,14.87
172,168,0,470,480,10,7.21,9.33,13.76
172,168,1,626,640,14,7.05,11.53,14.93
172,168,2,883,892,9,13.04,13.7,14.88
172,171,0,915,927,12,4.64,9.14,14.63
172,173,0,537,542,5,11.97,12.78,13.79
172,173,1,640,643,3,12.85,13.48,14.17
172,174,0,503,509,6,10.29,11.97,14.28
172,175,0,475,477,2,13.91,14.26,14.7
172,177,0,600,604,4,12.84,13.58,14.55
172,178,0,670,676,6,4.84,8.8,13.64
172,179,0,652,670,18,3.52,8.23,13.98
173,166,0,885,891,6,11.35,12.57,14.3
173,167,0,535,536,1,14.76,14.88,15
173,168,0,638,679,41,1,7.78,14.2
173,169,0,713,728,15,6.82,9.93,14.56
173,169,1,756,767,11,1.06,7.62,14.48
173,170,0,616,626,10,2.29,7.7,13.76
173,170,1,784,793,9,10.09,11.81,14.35
173,171,0,720,724,4,12.37,13.24,14.36
173,172,0,537,542,5,11.97,12.78,13.79
173,172,1,640,643,3,12.85,13.48,14.17
173,174,0,516,523,7,4.56,8.08,12.23
173,174,1,870,876,6,6.03,9.03,12.71
173,175,0,484,489,5,10,11.9,14.48
173,175,1,731,740,9,1.2,8.65,14.14
173,175,2,814,822,8,1.42,7.7,14.23
173,176,0,814,818,4,11.2,12.32,13.64
173,177,0,511,518,7,3.94,8.35,13.39
173,178,0,678,684,6,6.6,10.02,13.74
173,179,0,621,633,12,10.71,12.18,14.43
173,179,1,802,807,5,8.69,10.5,12.72
173,339,0,925,925,0,6.14,6.14,6.14
174,166,0,457,463,6,2.12,6.53,12.53
174,166,1,735,749,14,3.09,8.16,14.51
174,166,2,829,838,9,1.19,7.8,14.41
174,166,3,1018,1023,5,3.73,7.48,13.61
174,167,0,586,590,4,12.21,13.19,14.86
174,169,0,473,487,14,1.5,7.83,14.95
174,170,0,537,558,21,3.97,8.74,14.99
174,170,1,776,781,5,12.66,13.6,14.94
174,170,2,979,986,7,7.87,10.19,13.3
174,171,0,663,672,9,5.45,9.34,14.59
174,171,1,1022,1023,1,12.93,13.79,14.65
174,172,0,503,509,6,10.29,11.97,14.28
174,173,0,516,523,7,4.56,8.08,12.23
174,173,1,870,876,6,6.03,9.03,12.71
174,175,0,459,462,3,12.56,13.16,13.92
174,175,1,774,780,6,8.82,11.06,14.82
175,165,0,894,903,9,7.18,9.96,13.62
175,166,0,459,491,32,0.71,7.71,14.93
175,166,1,513,520,7,5.99,10.06,14.9
175,166,2,863,870,7,6.74,9.85,13.91
175,166,3,984,989,5,12.82,13.43,14.34
175,167,0,885,894,9,11.47,12.83,14.91
175,167,1,898,952,54,1.67,7.76,14.73
175,168,0,1010,1016,6,10.31,11.93,14.08
175,169,0,742,748,6,12.82,13.62,14.84
175,170,0,443,446,3,13.18,13.62,14.1
175,170,1,768,780,12,9.69,11.62,14.88
175,171,0,612,620,8,9.61,11.54,14.45
175,171,1,828,830,2,14.33,14.57,14.92
175,172,0,475,477,2,13.91,14.26,14.7
175,173,0,484,489,5,10,11.9,14.48
175,173,1,731,740,9,1.2,8.47,14.14
175,173,2,814,822,8,1.42,7.7,14.23
175,174,0,459,462,3,12.56,13.16,13.92
175,174,1,774,780,6,8.82,11.06,14.82
175,176,0,802,818,16,3.19,8.31,14.91
175,176,1,977,977,0,4.53,4.53,4.53
175,177,0,441,446,5,6.35,9.55,14.34
175,177,1,667,677,10,2.58,7.88,14.52
175,177,2,898,905,7,10.41,11.92,14
175,178,0,1012,1022,10,4.32,9.03,14.88
175,178,1,1048,1061,13,8.93,11.48,14.52
175,179,0,500,505,5,8.32,10.45,13.34
175,179,1,572,578,6,8.23,10.99,14.95
175,179,2,792,797,5,8.32,10.38,13
176,5,0,880,880,0,5.4,5.4,5.4
176,165,0,713,722,9,6.41,9.89,14.81
176,165,1,976,976,0,8.51,8.51,8.51
176,166,0,564,570,6,11.45,12.63,14.23
176,167,0,586,597,11,4.64,8.51,13.45
176,168,0,511,516,5,12.11,13.03,14.48
176,168,1,724,733,9,3.79,8.27,13.64
176,169,0,518,529,11,6.58,9.61,13.88
176,169,1,679,691,12,0.34,7.23,13.57
176,169,2,975,975,0,3.74,3.74,3.74
176,170,0,717,723,6,13.16,13.66,14.27
176,173,0,814,818,4,11.2,12.32,13.64
176,175,0,802,818,16,3.19,8.61,14.91
176,175,1,977,977,0,4.53,4.53,4.53
176,177,0,746,753,7,7.71,10.46,14.32
176,177,1,976,976,0,10.33,10.33,10.33
176,178,0,474,482,8,7.18,10.22,14.45
176,178,1,567,573,6,11.86,13.22,14.99
176,179,0,701,723,22,4.28,8.53,14.29
176,244,0,887,892,5,12.23,13.07,14.26
176,297,0,880,880,0,11.32,11.32,11.32
177,165,0,521,530,9,2.03,7.65,13.55
177,165,1,813,820,7,9.78,11.71,14.3
177,165,2,909,967,58,3.69,7.77,14.62
177,166,0,711,713,2,13.48,13.8,14.03
177,167,0,613,620,7,1.9,7.3,12.86
177,167,1,987,999,12,1.66,7.48,13.58
177,169,0,447,458,11,7.5,10.68,14.7
177,169,1,806,816,10,7.03,10.01,14.31
177,170,0,439,454,15,1.12,7.65,14.83
177,170,1,491,496,5,13.26,13.89,14.86
177,170,2,601,610,9,1.39,7.54,14.09
177,171,0,554,575,21,2.66,7.85,14.57
177,171,1,763,766,3,13.79,14.25,14.95
177,172,0,600,604,4,12.84,13.58,14.55
177,172,1,1051,1066,15,6.27,9.63,14.45
177,173,0,511,518,7,3.94,8.35,13.39
177,175,0,431,446,15,6.35,9.25,14.34
177,175,1,667,677,10,2.58,7.88,14.52
177,175,2,898,905,7,10.41,11.92,14
177,176,0,746,753,7,7.71,10.46,14.32
177,176,1,976,976,0,10.33,10.33,10.33
177,178,0,428,431,3,9.75,12.28,14.81
177,179,0,960,967,7,8.35,10.5,13.44
178,165,0,588,597,9,6.22,9.69,14.22
178,166,0,531,537,6,10.93,12.32,14.25
178,166,1,548,612,64,2.36,8.76,14.8
178,167,0,1022,1029,7,8.9,10.95,13.73
178,168,0,973,1000,27,9.88,12.16,15
178,170,0,558,564,6,9.97,11.91,14.97
178,170,1,760,767,7,11.33,12.82,14.93
178,171,0,525,532,7,7.91,10.69,14.39
178,171,1,641,647,6,9.22,11.26,14.11
178,172,0,670,676,6,4.84,8.8,13.64
178,173,0,678,684,6,6.6,10.02,13.74
178,175,0,1012,1022,10,4.32,9.03,14.88
178,176,0,474,482,8,7.18,10.22,14.45
178,176,1,567,573,6,11.86,13.22,14.99
178,179,0,512,514,2,13.14,13.48,13.67
178,179,1,671,674,3,13.06,13.8,14.97
178,179,2,747,753,6,9.33,11.72,14.9
178,286,0,887,895,8,11.25,12.65,14.69
178,287,0,883,890,7,9.53,11.59,14.37
178,290,0,816,816,0,10.63,10.63,10.63
178,293,0,942,955,13,5.11,8.39,14.8
178,296,0,938,955,17,11.18,12.28,14.89
178,298,0,817,817,0,11.51,11.51,11.51
178,298,1,871,883,12,1.7,7.61,14.37
179,165,0,716,722,6,12.21,13.14,14.7
179,165,1,964,973,9,8.12,10.58,14.3
179,166,0,507,511,4,12.32,13.24,14.94
179,167,0,702,706,4,10.98,12.1,13.39
179,168,0,547,552,5,11.58,12.76,14.69
179,168,1,813,820,7,9.69,11.86,14.96
179,168,2,901,909,8,2.38,7.57,12.69
179,168,3,990,1026,36,4.97,8.64,14.52
179,169,0,548,561,13,0.76,7.61,14.59
179,169,1,973,973,0,11.74,11.74,11.74
179,169,2,978,991,13,4.94,8.73,13.74
179,171,0,595,603,8,6.87,9.75,13.46
179,171,1,935,949,14,4.16,8.5,14.32
179,172,0,652,670,18,3.52,8.23,13.98
179,173,0,621,633,12,10.71,12.18,14.43
179,173,1,802,807,5,8.69,10.5,12.72
179,175,0,500,505,5,8.32,10.45,13.34
179,175,1,572,578,6,8.23,10.99,14.95
179,175,2,792,797,5,8.32,10.38,13
179,176,0,701,723,22,4.28,8.41,14.29
179,177,0,960,967,7,8.35,10.5,13.44
179,178,0,512,514,2,13.14,13.48,13.67
179,178,1,671,674,3,13.06,13.8,14.97
179,178,2,747,753,6,9.33,11.72,14.9
180,181,0,513,542,29,1.07,8.38,14.93
180,181,1,827,850,23,2.06,9.18,14.64
180,182,0,749,757,8,8.15,10.65,14.22
180,183,0,683,694,11,4.71,9.38,14.5
180,183,1,1047,1061,14,7.04,10.22,14.58
180,184,0,900,948,48,0.9,8.18,14.84
180,186,0,787,799,12,5.45,9.15,14.01
180,186,1,990,1004,14,7.46,10.36,14.4
180,187,0,485,493,8,7.63,10.3,14.05
180,187,1,591,601,10,3.24,8.18,13.93
180,187,2,702,723,21,7.52,9.94,14
180,187,3,919,927,8,8.32,10.83,14.8
180,189,0,439,444,5,11.28,12.81,14.41
180,190,0,753,760,7,10.35,11.83,13.99
180,191,0,844,854,10,7.3,10.34,14.96
180,192,0,578,587,9,12.26,13.3,14.86
180,193,0,769,782,13,2.34,7.85,14.19
180,193,1,987,989,2,3.15,10.2,14.43
180,194,0,683,723,40,6.91,9.24,14.7
181,180,0,513,542,29,1.07,8.3,14.93
181,180,1,827,850,23,2.06,9.38,14.64
181,182,0,671,678,7,10.22,12.05,14.44
181,182,1,884,893,9,2.52,7.93,14.46
181,183,0,960,969,9,1.38,7.28,13.35
181,184,0,726,739,13,4.37,8.77,14.79
181,184,1,861,871,10,10.48,12.22,14.82
181,185,0,780,790,10,10.99,12.45,14.84
181,186,0,694,700,6,11.49,12.59,14.27
181,187,0,428,443,15,4.05,7.67,14.38
181,187,1,628,639,11,4.35,9.05,14.5
181,188,0,654,667,13,3.8,8.35,14
181,191,0,640,647,7,10,11.94,14.63
181,191,1,843,852,9,3.69,8.55,14.38
181,192,0,621,632,11,2.22,8.15,14.77
181,192,1,957,964,7,10.32,11.82,14.11
181,193,0,662,690,28,5.25,9.19,14.91
181,193,1,699,703,4,14.84,14.89,15
181,193,2,706,715,9,2.71,7.74,13.45
181,194,0,936,944,8,14.38,14.56,14.86
182,180,0,749,757,8,8.15,10.65,14.22
182,181,0,671,678,7,10.22,12.05,14.44
182,181,1,884,893,9,2.52,7.93,14.46
182,183,0,907,911,4,10.97,12.29,14.36
182,184,0,443,447,4,10.28,12.13,14.1
182,184,1,548,556,8,8.28,10.82,14.3
182,184,2,673,681,8,9.68,11.51,14.4
182,184,3,1004,1010,6,13.69,14.17,14.93
182,185,0,443,447,4,6.79,9.85,13.2
182,185,1,579,588,9,2.28,7.5,13.25
182,185,2,716,724,8,7.04,9.88,13.36
182,185,3,855,858,3,13.76,14.07,14.42
182,186,0,551,559,8,0.68,7.63,14.16
182,186,1,953,960,7,6.81,9.93,13.91
182,187,0,823,829,6,8.07,11.07,14.98
182,187,1,908,916,8,4.69,8.97,14.91
182,188,0,705,730,25,0.91,7.57,14.59
182,188,1,1024,1032,8,10.05,11.87,14.62
182,189,0,742,752,10,10.19,11.97,14.64
182,189,1,1043,1050,7,12.1,12.92,14.11
182,190,0,762,778,16,11.98,12.98,14.66
182,190,1,869,878,9,12.81,14.01,14.79
182,190,2,1035,1043,8,0.81,7.44,13.78
182,192,0,792,800,8,3.77,8.89,14.64
182,193,0,572,579,7,2.79,8.12,14.25
182,193,1,668,676,8,7.7,10.55,14.83
182,194,0,494,502,8,11.34,12.8,14.94
182,194,1,512,523,11,12.88,13.59,14.77
182,194,2,534,545,11,9.65,11.54,14.33
182,194,3,852,867,15,0.52,7.63,14.78
183,180,0,683,693,10,4.71,9.18,14.21
183,180,1,1047,1047,0,14.58,14.58,14.58
183,181,0,960,969,9,1.38,7.28,13.35
183,182,0,907,911,4,10.97,12.29,14.36
183,184,0,622,631,9,5.93,9.59,14.71
183,184,1,764,787,23,3.27,7.81,14.6
183,185,0,517,525,8,8.27,10.8,14.72
183,185,1,1026,1047,21,6.11,8.98,14.09
183,186,0,616,619,3,12.95,13.41,13.95
183,186,1,816,825,9,4.16,8.51,13.95
183,187,0,530,532,2,14.25,14.5,14.88
183,187,1,611,618,7,6.48,9.55,13.5
183,187,2,778,785,7,2.77,8.41,14.4
183,187,3,897,909,12,3.42,8.38,14.75
183,187,4,1027,1030,3,12.38,13.09,13.99
183,188,0,894,911,17,7.58,10.39,14.46
183,188,1,988,995,7,9.55,11.26,13.68
183,189,0,586,595,9,10.5,12.25,14.95
183,189,1,843,851,8,7.34,9.99,13.67
183,190,0,486,487,1,14.82,14.84,14.85
183,190,1,651,659,8,6.39,9.51,13.43
183,190,2,818,825,7,1.6,7.33,13.1
183,190,3,986,992,6,9.13,11.52,14.91
183,191,0,797,807,10,2.34,8.43,14.81
183,192,0,486,497,11,2.55,7.45,12.91
183,192,1,541,575,34,4.66,8.71,14.5
183,192,2,605,616,11,5.57,9.25,14.3
183,192,3,724,734,10,7.73,10.39,13.98
183,192,4,844,852,8,10.95,12.39,14.37
183,192,5,887,908,21,12,13.03,14.83
183,192,6,965,973,8,13.18,13.67,14.3
183,193,0,477,488,11,8.43,11.24,14.46
183,193,1,629,636,7,3.21,8.09,13.42
183,194,0,675,698,23,1.13,7.69,14.76
183,194,1,802,812,10,4.09,8.92,14.93
183,194,2,985,1007,22,2.44,7.83,14.31
184,180,0,900,948,48,0.9,8.25,14.84
184,181,0,726,739,13,4.37,8.77,14.79
184,181,1,861,871,10,10.48,12.22,14.82
184,182,0,424,424,0,14.52,14.52,14.52
184,182,1,436,447,11,9.53,12.16,14.85
184,182,2,548,556,8,8.28,10.82,14.3
184,182,3,673,681,8,9.68,11.51,14.4
184,182,4,1004,1010,6,13.69,14.17,14.93
184,183,0,622,631,9,5.93,9.59,14.71
184,183,1,764,787,23,3.27,8.09,14.6
184,185,0,424,462,38,2.37,8.54,14.42
184,185,1,813,832,19,1.68,7.75,14.52
184,186,0,550,590,40,5.44,10.99,14.62
184,186,1,703,711,8,10.39,11.99,14.57
184,186,2,1036,1048,12,9.27,11.82,14.67
184,187,0,778,789,11,3.57,8.69,14.81
184,187,1,921,926,5,12.72,13.56,14.93
184,188,0,663,675,12,9.61,11.65,14.9
184,189,0,647,660,13,10.14,11.91,14.93
184,190,0,574,585,11,8.45,10.93,14.83
184,191,0,645,653,8,8.09,10.72,14.38
184,191,1,989,998,9,1.5,7.17,12.89
184,193,0,634,666,32,3.5,8.5,14.89
184,193,1,717,723,6,11.74,12.84,14.58
184,194,0,568,575,7,14.37,14.57,14.87
185,181,0,780,790,10,10.99,12.45,14.84
185,182,0,579,588,9,2.28,7.5,13.25
185,182,1,716,724,8,7.04,9.88,13.36
185,182,2,855,858,3,13.76,14.07,14.42
185,183,0,517,525,8,8.27,10.8,14.72
185,183,1,1026,1028,2,12.13,13.1,14.09
185,184,0,462,462,0,13.78,13.78,13.78
185,184,1,813,832,19,1.68,7.75,14.52
185,186,0,479,498,19,7.89,10.6,14.86
185,186,1,744,755,11,6.72,10.02,14.75
185,187,0,1009,1022,13,1.13,7.1,13.15
185,188,0,715,730,15,6.27,9.8,14.62
185,190,0,662,678,16,7.78,10.56,14.81
185,190,1,726,732,6,12.7,13.49,14.6
185,190,2,962,972,10,6.96,10.14,14.39
185,191,0,670,684,14,9.93,11.5,14.03
185,191,1,964,978,14,0.31,7.68,14.64
185,193,0,508,521,13,2.77,8.34,14.94
185,193,1,542,564,22,10.65,12.31,14.84
185,193,2,1005,1014,9,8.97,11.05,14
185,194,0,837,858,21,6.95,10.09,14.68
186,180,0,787,799,12,5.45,9.15,14.01
186,180,1,990,1004,14,7.46,10.36,14.4
186,181,0,694,700,6,11.49,12.59,14.27
186,182,0,551,559,8,0.68,7.63,14.16
186,182,1,953,960,7,6.81,9.93,13.91
186,183,0,616,619,3,12.95,13.41,13.95
186,183,1,816,825,9,4.16,8.51,13.95
186,184,0,550,590,40,5.44,11.04,14.62
186,184,1,703,711,8,10.39,11.99,14.57
186,184,2,1036,1043,7,9.27,11.85,14.67
186,185,0,479,498,19,7.89,10.66,14.86
186,185,1,744,755,11,6.72,10.02,14.75
186,187,0,841,843,2,14.29,14.46,14.66
186,189,0,625,637,12,5.95,9.68,14.39
186,190,0,582,590,8,8.77,11.26,14.53
186,190,1,818,828,10,4.28,8.45,13.36
186,192,0,505,515,10,3.99,8.67,14.4
186,193,0,501,508,7,7.06,10.01,14.28
186,193,1,687,696,9,2.26,8.12,14
186,194,0,566,584,18,3,7.94,14.48
186,194,1,1037,1038,1,14.8,14.83,14.86
187,180,0,485,493,8,7.63,10.3,14.05
187,180,1,591,601,10,3.24,8.18,13.93
187,180,2,702,723,21,7.52,10.06,14
187,180,3,919,927,8,8.32,10.83,14.8
187,181,0,628,639,11,4.35,9.45,14.5
187,182,0,823,829,6,8.07,11.07,14.98
187,182,1,908,916,8,4.69,8.97,14.91
187,183,0,530,532,2,14.25,14.5,14.88
187,183,1,611,618,7,6.48,9.55,13.5
187,183,2,778,785,7,2.77,8.41,14.4
187,183,3,897,909,12,3.42,8.38,14.75
187,183,4,1027,1030,3,12.38,13.09,13.99
187,184,0,778,789,11,3.57,9.09,14.81
187,184,1,921,926,5,12.72,13.56,14.93
187,185,0,1009,1022,13,1.13,7.1,13.15
187,186,0,841,843,2,14.29,14.46,14.66
187,188,0,896,907,11,4.52,8.86,14.89
187,189,0,881,896,15,4.81,9.28,14.93
187,190,0,665,671,6,9.57,11.75,14.62
187,191,0,716,720,4,13.29,13.97,14.88
187,191,1,895,896,1,14.1,14.11,14.12
187,192,0,521,525,4,13.67,14.11,14.88
187,192,1,614,625,11,13.84,14.28,14.98
187,192,2,893,904,11,3.84,8.61,14.28
187,194,0,700,705,5,13.18,13.85,14.93
187,194,1,714,737,23,1.39,7.68,14.78
187,194,2,1039,1044,5,4.38,8.24,13.81
188,32,0,768,786,18,7.94,10.17,14.7
188,37,0,766,766,0,6.79,6.79,6.79
188,37,1,778,782,4,12.5,13.49,14.53
188,43,0,804,807,3,12.02,12.76,13.7
188,181,0,654,667,13,3.8,8.35,14
188,182,0,705,730,25,0.91,7.57,14.59
188,182,1,1024,1032,8,10.05,11.87,14.62
188,183,0,452,475,23,10,11.81,14.92
188,183,1,894,911,17,7.58,10.39,14.46
188,183,2,988,995,7,9.55,11.26,13.68
188,184,0,663,675,12,9.61,11.65,14.9
188,185,0,715,730,15,6.27,9.8,14.62
188,187,0,896,907,11,4.52,8.86,14.89
188,189,0,919,973,54,5.27,9.21,14.98
188,190,0,981,998,17,2.43,7.86,14.08
188,191,0,444,470,26,8.03,10.62,14.61
188,191,1,615,620,5,14.66,14.78,14.98
188,191,2,889,890,1,14.89,14.92,14.95
188,192,0,681,692,11,8.29,10.83,14.82
188,192,1,881,919,38,4.87,8.96,14.64
188,193,0,458,476,18,3.63,8.38,14.37
188,193,1,659,667,8,9.85,11.94,14.6
188,194,0,980,996,16,8.1,10.6,14.37
189,182,0,742,752,10,10.19,11.97,14.64
189,182,1,1043,1050,7,12.1,12.92,14.11
189,183,0,586,595,9,10.5,12.25,14.95
189,183,1,843,851,8,7.34,9.99,13.67
189,184,0,647,660,13,10.14,11.91,14.93
189,186,0,625,637,12,5.95,9.68,14.39
189,187,0,881,896,15,4.81,9.28,14.93
189,188,0,919,973,54,5.27,9.21,14.98
189,190,0,999,1017,18,9.76,11.56,14.49
189,190,1,1026,1037,11,6.09,9.62,14.39
189,191,0,895,908,13,4.19,8.88,14.61
189,192,0,830,846,16,1.37,7.71,14.74
189,192,1,911,920,9,14.43,14.61,14.9
189,193,0,647,657,10,6.94,10.16,14.57
190,180,0,753,760,7,10.35,11.83,13.99
190,182,0,762,778,16,11.98,12.98,14.66
190,182,1,869,878,9,12.81,14.01,14.79
190,182,2,1035,1043,8,0.81,7.87,13.78
190,183,0,486,487,1,14.82,14.84,14.85
190,183,1,651,659,8,6.39,9.69,13.43
190,183,2,818,825,7,1.6,7.33,13.1
190,183,3,986,992,6,9.13,11.52,14.91
190,184,0,574,585,11,8.45,10.93,14.83
190,185,0,662,678,16,7.78,10.56,14.81
190,185,1,726,732,6,12.7,13.49,14.6
190,185,2,962,972,10,6.96,10.14,14.39
190,186,0,582,590,8,8.77,11.26,14.53
190,186,1,818,828,10,4.28,8.45,13.36
190,187,0,665,671,6,9.57,11.47,14.62
190,188,0,981,998,17,2.43,7.86,14.08
190,189,0,999,1017,18,9.76,11.56,14.49
190,189,1,1026,1037,11,6.09,9.62,14.39
190,191,0,668,676,8,3.82,9.17,14.9
190,191,1,922,927,5,14.5,14.66,14.91
190,191,2,958,972,14,4.03,8.48,13.87
190,192,0,460,485,25,3.95,10.22,14.54
190,193,0,598,601,3,13.93,14.23,14.54
190,194,0,528,528,0,14.9,14.9,14.9
190,194,1,589,608,19,7.45,10.26,14.6
190,194,2,981,992,11,3.01,8.31,14.8
191,180,0,844,854,10,7.3,10.34,14.96
191,181,0,640,647,7,10,11.94,14.63
191,181,1,843,852,9,3.69,8.55,14.38
191,183,0,797,807,10,2.34,8.43,14.81
191,184,0,645,653,8,8.09,10.72,14.38
191,184,1,989,998,9,1.5,7.17,12.89
191,185,0,670,684,14,9.93,11.6,14.03
191,185,1,964,978,14,0.31,7.68,14.64
191,187,0,716,720,4,13.29,13.97,14.88
191,187,1,895,896,1,14.1,14.11,14.12
191,188,0,615,620,5,14.66,14.78,14.98
191,188,1,889,890,1,14.89,14.92,14.95
191,189,0,895,908,13,4.19,8.88,14.61
191,190,0,668,676,8,3.82,9.17,14.9
191,190,1,922,927,5,14.5,14.66,14.91
191,190,2,958,972,14,4.03,8.48,13.87
191,192,0,759,767,8,3.58,8.85,14.39
191,193,0,647,651,4,11.67,12.77,14.51
191,194,0,708,719,11,5.65,9.24,14.13
191,194,1,797,805,8,12.58,13.57,14.91
192,180,0,578,587,9,12.26,13.3,14.86
192,181,0,621,632,11,2.22,8.15,14.77
192,181,1,957,964,7,10.32,11.82,14.11
192,182,0,792,800,8,3.77,8.89,14.64
192,183,0,486,497,11,2.55,7.45,12.91
192,183,1,541,575,34,4.66,8.76,14.5
192,183,2,605,616,11,5.57,9.25,14.3
192,183,3,724,734,10,7.73,10.39,13.98
192,183,4,844,852,8,10.95,12.39,14.37
192,183,5,887,908,21,12,13.03,14.83
192,183,6,965,973,8,13.18,13.78,14.62
192,186,0,505,515,10,3.99,8.67,14.4
192,187,0,521,525,4,13.67,14.11,14.88
192,187,1,614,625,11,13.84,14.28,14.98
192,187,2,893,904,11,3.84,8.61,14.28
192,188,0,681,692,11,8.29,10.83,14.82
192,188,1,881,919,38,4.87,8.96,14.64
192,189,0,830,846,16,1.37,7.71,14.74
192,189,1,911,920,9,14.43,14.61,14.9
192,190,0,472,485,13,3.95,8.02,13.47
192,191,0,759,767,8,3.58,8.85,14.39
192,193,0,492,503,11,11.66,12.89,14.82
192,194,0,957,959,2,14.72,14.83,14.94
193,180,0,769,782,13,2.34,7.85,14.19
193,180,1,987,989,2,3.15,10.2,14.43
193,181,0,662,690,28,5.25,9.19,14.91
193,181,1,699,703,4,14.84,14.89,15
193,181,2,706,715,9,2.71,7.74,13.45
193,182,0,572,579,7,2.79,8.12,14.25
193,182,1,668,676,8,7.7,10.55,14.83
193,183,0,465,488,23,4.65,9.5,14.46
193,183,1,629,636,7,3.21,8.09,13.42
193,184,0,634,666,32,3.5,8.5,14.89
193,184,1,717,723,6,11.74,12.84,14.58
193,184,2,1056,1064,8,7.97,10.28,14.93
193,185,0,508,521,13,2.77,8.34,14.94
193,185,1,542,564,22,10.65,12.22,14.84
193,185,2,1005,1014,9,8.97,11.05,14
193,186,0,501,508,7,7.06,10.01,14.28
193,186,1,687,696,9,0.74,7.79,14
193,186,2,1061,1064,3,8.12,11.11,14.1
193,188,0,458,476,18,3.63,8.38,14.37
193,188,1,659,667,8,9.85,11.94,14.6
193,189,0,647,657,10,6.94,10.16,14.57
193,190,0,598,601,3,13.93,14.23,14.54
193,191,0,456,470,14,1.13,6.94,14.8
193,191,1,647,651,4,11.67,12.77,14.51
193,192,0,492,503,11,11.66,12.89,14.82
193,194,0,602,608,6,12.17,13.09,14.31
193,242,0,838,849,11,1.84,7.84,14.2
193,242,1,949,962,13,13.25,14.14,14.97
194,180,0,682,723,41,6.91,9.39,14.96
194,181,0,936,944,8,14.38,14.59,14.86
194,182,0,494,502,8,11.34,12.8,14.94
194,182,1,512,523,11,12.88,13.59,14.77
194,182,2,534,545,11,9.65,11.54,14.33
194,182,3,852,867,15,0.52,7.63,14.78
194,183,0,675,698,23,1.13,7.85,14.76
194,183,1,802,812,10,4.09,8.92,14.93
194,183,2,985,1007,22,2.44,7.83,14.31
194,184,0,568,575,7,14.37,14.57,14.87
194,185,0,837,858,21,6.95,10.09,14.68
194,186,0,566,584,18,3,8.26,14.48
194,186,1,1037,1038,1,14.8,14.83,14.86
194,187,0,700,705,5,13.18,13.85,14.93
194,187,1,714,737,23,1.39,7.68,14.78
194,187,2,1039,1048,9,4.38,6.98,13.81
194,188,0,980,996,16,8.1,10.6,14.37
194,190,0,528,528,0,14.9,14.9,14.9
194,190,1,589,608,19,7.45,10.26,14.6
194,190,2,981,992,11,3.01,8.31,14.8
194,191,0,708,719,11,5.65,9.24,14.13
194,191,1,797,805,8,12.58,13.57,14.91
194,192,0,957,959,2,14.72,14.83,14.94
194,193,0,602,608,6,12.17,13.09,14.31
195,141,0,916,916,0,13.7,13.7,13.7
195,196,0,536,546,10,9.7,11.62,14.67
195,196,1,828,836,8,12.15,13.26,14.95
195,198,0,716,731,15,1.02,7.69,14.68
195,198,1,1025,1034,9,10.74,12.43,14.89
195,199,0,851,863,12,10.89,12.32,14.44
195,199,1,1036,1044,8,8.43,10.99,14.69
195,200,0,774,780,6,12.2,13.13,14.44
195,201,0,969,973,4,12.41,13.19,14.14
195,202,0,495,501,6,12.97,13.65,14.79
195,202,1,623,631,8,5.38,9.38,13.97
195,203,0,505,516,11,2.3,7.76,13.97
195,203,1,711,731,20,0.83,7.54,14.94
195,204,0,500,510,10,11.1,12.48,14.65
195,206,0,572,589,17,1.88,8.07,14.84
195,206,1,791,814,23,7.07,10.09,14.08
195,206,2,1028,1037,9,12.76,13.64,14.99
195,208,0,448,463,15,10.36,12.01,14.65
195,208,1,647,657,10,7.53,10.66,14.91
195,209,0,723,734,11,11.61,12.64,14.21
195,209,1,910,910,0,4.32,4.32,4.32
195,209,2,1007,1020,13,10.9,12.28,14.52
196,141,0,923,932,9,14.1,14.41,14.96
196,195,0,536,546,10,9.7,11.62,14.67
196,195,1,828,836,8,12.15,13.26,14.95
196,197,0,777,818,41,7.09,10.16,14.97
196,197,1,847,866,19,5.72,11.53,14.88
196,198,0,884,894,10,8.78,11.16,14.35
196,198,1,1007,1015,8,11.63,12.96,14.92
196,201,0,872,891,19,3.39,8.06,13.78
196,201,1,901,920,19,7.11,10.21,14.71
196,202,0,680,689,9,2.64,8.03,14.67
196,202,1,895,905,10,1.61,8.22,14.64
196,203,0,472,482,10,5.02,8.86,13.86
196,204,0,771,789,18,10.77,12.41,14.96
196,206,0,717,740,23,9.83,12.73,14.78
196,206,1,819,825,6,11.49,13.02,14.87
196,206,2,907,914,7,8.06,10.61,14.45
196,206,3,995,1002,7,7.94,10.5,14.34
196,207,0,815,830,15,10.44,12.05,14.71
196,208,0,746,754,8,13.86,14.25,14.96
196,208,1,762,786,24,0.16,7.71,14.95
196,208,2,1030,1043,13,10.47,11.6,14.29
197,196,0,777,818,41,7.09,10.16,14.97
197,196,1,847,866,19,5.72,11.41,14.88
197,198,0,644,656,12,2.27,8.15,14.97
197,200,0,512,522,10,5.26,9.08,13.68
197,200,1,1010,1018,8,12.8,13.68,14.95
197,201,0,933,969,36,3.97,8.69,14.86
197,201,1,1011,1020,9,11.53,12.77,14.9
197,202,0,997,1000,3,13.23,13.7,14.29
197,203,0,695,704,9,3.93,8.18,13.37
197,203,1,1011,1017,6,10.54,11.84,13.46
197,204,0,717,731,14,8.71,11.13,14.74
197,204,1,749,781,32,1.36,7.77,14.76
197,205,0,455,466,11,4.45,8.45,13.44
197,205,1,668,676,8,13.47,14,14.92
197,206,0,480,482,2,13.82,14.08,14.38
197,206,1,815,823,8,1.55,7.57,13.48
197,207,0,807,822,15,4.91,8.93,14.26
197,207,1,875,898,23,5.72,9.4,14.85
197,207,2,1001,1019,18,7.02,10.05,14.77
197,208,0,775,787,12,9.24,11.42,14.69
197,209,0,532,539,7,5.16,8.76,13.5
197,209,1,701,708,7,7.92,10.65,14.48
197,209,2,871,876,5,11.61,12.87,14.72
198,141,0,987,989,2,8.8,11.39,14.02
198,195,0,716,731,15,1.02,7.69,14.68
198,195,1,1025,1034,9,10.74,12.43,14.89
198,196,0,884,894,10,8.78,11.16,14.35
198,196,1,1007,1015,8,11.63,12.96,14.92
198,197,0,644,656,12,2.27,8.15,14.97
198,199,0,987,1001,14,5.08,9.02,14.26
198,200,0,712,717,5,13.96,14.31,14.89
198,200,1,950,971,21,6.15,9.78,14.89
198,201,0,737,746,9,12.18,13.14,14.57
198,201,1,885,894,9,3.3,7.76,12.83
198,202,0,592,600,8,5.97,9.53,14.09
198,202,1,1037,1046,9,2.49,8.08,14.03
198,203,0,717,728,11,4.61,9.12,14.6
198,204,0,845,854,9,13.4,13.97,14.86
198,205,0,628,637,9,1.78,7.35,13.27
198,206,0,933,938,5,11.75,12.8,14.29
198,206,1,952,980,28,6.59,9.69,14.23
198,206,2,1021,1030,9,3.96,8.85,14.72
198,209,0,722,726,4,12.8,13.5,14.39
198,209,1,809,817,8,6.87,10.15,14.22
198,209,2,840,849,9,14.19,14.42,14.8
199,195,0,851,863,12,10.89,12.32,14.44
199,195,1,1036,1044,8,8.43,10.99,14.69
199,198,0,987,1001,14,5.08,9.02,14.26
199,200,0,883,891,8,1.87,7.45,13.32
199,200,1,977,984,7,7.71,9.99,12.94
199,201,0,758,765,7,5.24,9.32,14.9
199,202,0,666,672,6,8.09,10.65,13.82
199,202,1,1044,1050,6,7.91,10.51,13.84
199,203,0,682,693,11,1.54,7.35,13.37
199,204,0,701,707,6,12.09,13.1,14.93
199,204,1,818,821,3,14.25,14.49,14.8
199,204,2,936,946,10,5.61,9.42,14.45
199,205,0,517,525,8,4.23,9,14.49
199,205,1,600,604,4,11.46,12.39,13.37
199,205,2,761,767,6,9.79,12.05,14.76
199,205,3,949,964,15,9.87,11.79,14.73
199,206,0,495,507,12,5.14,8.78,13.35
199,206,1,827,835,8,1.14,7.35,13.42
199,206,2,1032,1034,2,14.33,14.54,14.72
199,207,0,535,569,34,4.18,9.25,14.57
199,207,1,832,852,20,4.95,8.9,14.13
199,207,2,961,967,6,13,13.62,14.5
199,208,0,792,802,10,4.01,8.54,13.68
199,208,1,899,906,7,12.74,13.63,14.81
199,209,0,693,695,2,13.89,14.13,14.27
199,209,1,791,799,8,4.89,8.75,13.87
199,209,2,975,984,9,8.16,10.59,14.3
200,132,0,924,924,0,14.09,14.09,14.09
200,195,0,774,780,6,12.2,13.13,14.44
200,197,0,512,521,9,5.26,8.76,13.68
200,197,1,1010,1018,8,12.8,13.68,14.95
200,198,0,712,717,5,13.96,14.31,14.89
200,198,1,950,971,21,6.15,9.78,14.89
200,199,0,883,891,8,1.87,7.45,13.32
200,199,1,977,984,7,7.71,9.99,12.94
200,201,0,626,633,7,9.97,11.95,14.66
200,201,1,725,725,0,14.84,14.84,14.84
200,202,0,913,920,7,2.62,7.34,12.42
200,203,0,713,713,0,14.89,14.89,14.89
200,203,1,1011,1023,12,8,10.76,14.83
200,206,0,606,618,12,3.07,8.32,14.69
200,206,1,926,932,6,11.53,12.87,14.6
200,206,2,958,972,14,2.33,8.07,14.58
200,207,0,735,753,18,10.55,12.11,14.76
200,207,1,765,778,13,5.42,9.28,14.25
200,207,2,1003,1030,27,1.69,7.53,14.86
200,209,0,718,728,10,9.12,11.06,13.93
200,209,1,980,988,8,0.23,7.41,13.48
201,141,0,918,928,10,2.45,6.87,13.44
201,195,0,969,973,4,12.41,13.19,14.14
201,196,0,872,891,19,3.39,8.06,13.78
201,196,1,901,920,19,7.11,10.21,14.71
201,197,0,933,969,36,3.97,8.7,14.86
201,197,1,1011,1020,9,11.53,12.77,14.9
201,198,0,737,746,9,12.18,13.14,14.57
201,198,1,885,894,9,3.3,7.76,12.83
201,199,0,758,765,7,5.24,9.32,14.9
201,200,0,626,633,7,9.97,11.95,14.66
201,200,1,725,725,0,14.84,14.84,14.84
201,202,0,432,441,9,11.32,12.64,14.74
201,202,1,612,616,4,13.8,14.38,14.98
201,202,2,705,713,8,4.74,8.37,12.56
201,202,3,799,808,9,4.97,9.01,13.9
201,202,4,895,900,5,13.9,14.36,14.92
201,202,5,989,994,5,7.82,10.1,13.03
201,203,0,813,821,8,5.68,9.7,14.35
201,204,0,606,615,9,3.65,8.2,13.39
201,204,1,1036,1051,15,4.28,9.12,14.92
201,205,0,451,458,7,5.26,8.79,13.07
201,205,1,756,786,30,0.23,8.81,14.99
201,205,2,1049,1054,5,6.66,10.19,14.28
201,206,0,424,433,9,0.47,6.38,14.23
201,206,1,668,673,5,10.76,12.37,14.8
201,206,2,905,912,7,4.3,8.7,13.99
201,208,0,498,509,11,4.45,8.8,14.42
201,208,1,827,835,8,9.25,11.33,14.71
201,209,0,562,565,3,12.86,13.55,14.55
201,209,1,640,645,5,11.13,12.68,14.94
201,209,2,877,879,2,13.82,14.14,14.37
202,123,0,943,946,3,11.99,12.68,13.49
202,132,0,923,923,0,13.52,13.52,13.52
202,195,0,495,501,6,12.97,13.65,14.79
202,195,1,623,631,8,5.38,9.38,13.97
202,196,0,680,689,9,2.64,8.03,14.67
202,196,1,895,905,10,1.61,8.22,14.64
202,197,0,997,1000,3,13.23,13.7,14.29
202,198,0,592,600,8,5.97,9.53,14.09
202,198,1,1037,1046,9,2.49,8.08,14.03
202,199,0,666,672,6,8.09,10.65,13.82
202,199,1,1044,1050,6,7.91,10.51,13.84
202,200,0,913,920,7,2.62,7.34,12.42
202,201,0,612,616,4,13.8,14.38,14.98
202,201,1,705,713,8,4.74,8.37,12.56
202,201,2,799,808,9,4.97,9.01,13.9
202,201,3,895,900,5,13.9,14.36,14.92
202,201,4,989,994,5,7.82,10.1,13.03
202,203,0,648,655,7,7.27,10.13,14.18
202,203,1,749,755,6,10.2,11.71,13.59
202,204,0,491,499,8,7.73,10.49,14.22
202,204,1,613,624,11,4.75,9.14,14.48
202,205,0,542,549,7,3.06,8.56,14.92
202,205,1,868,876,8,1.87,8.08,14.33
202,205,2,954,958,4,11.39,12.61,14.06
202,207,0,717,724,7,10.9,12.17,13.95
202,208,0,930,941,11,6.08,9.39,14.6
202,209,0,742,747,5,11.06,12.59,14.52
202,209,1,905,907,2,5.84,9.56,13.28
203,195,0,505,516,11,2.3,7.76,13.97
203,195,1,711,731,20,0.83,7.54,14.94
203,196,0,430,440,10,5.05,8.42,13.78
203,196,1,472,482,10,5.02,8.86,13.86
203,197,0,695,704,9,3.93,8.18,13.37
203,197,1,1011,1017,6,10.54,11.84,13.46
203,198,0,717,728,11,4.61,9.12,14.6
203,199,0,682,693,11,1.54,7.35,13.37
203,200,0,713,713,0,14.89,14.89,14.89
203,200,1,1011,1023,12,8,10.76,14.83
203,201,0,813,821,8,5.68,9.7,14.35
203,202,0,648,655,7,7.27,10.13,14.18
203,202,1,749,755,6,10.2,11.71,13.59
203,204,0,498,511,13,6.74,9.57,13.44
203,204,1,941,959,18,4.01,8.46,14.4
203,205,0,553,564,11,3.08,7.03,12.8
203,205,1,923,946,23,1.12,8.4,13.95
203,206,0,617,625,8,2.25,7.9,14.88
203,207,0,1010,1027,17,7.11,10.08,14.56
203,208,0,531,544,13,3.6,8.5,14.27
203,209,0,671,679,8,5.56,9.75,14.52
204,123,0,928,933,5,6.76,9.25,13.27
204,195,0,500,510,10,11.1,12.48,14.65
204,196,0,771,789,18,10.77,12.41,14.96
204,197,0,717,731,14,8.71,11.13,14.74
204,197,1,749,781,32,1.36,7.77,14.76
204,198,0,845,854,9,13.4,13.97,14.86
204,199,0,701,707,6,12.09,13.1,14.93
204,199,1,818,821,3,14.25,14.49,14.8
204,199,2,936,946,10,5.61,9.42,14.45
204,201,0,606,615,9,3.65,8.2,13.39
204,201,1,1036,1039,3,7.77,10.67,13.57
204,202,0,491,499,8,7.73,10.49,14.22
204,202,1,613,624,11,4.75,9.14,14.48
204,203,0,498,511,13,6.74,9.57,13.44
204,203,1,941,959,18,4.01,8.46,14.4
204,205,0,741,751,10,0.58,8.02,14.8
204,205,1,944,949,5,12.5,13.33,14.58
204,206,0,562,572,10,10.58,12.1,14.25
204,208,0,773,786,13,5.01,9,14.52
204,209,0,849,864,15,1.62,7.71,14.14
205,123,0,927,927,0,13.5,13.5,13.5
205,197,0,455,466,11,4.45,8.45,13.44
205,197,1,668,676,8,13.47,14,14.92
205,198,0,628,637,9,1.78,7.35,13.27
205,199,0,517,525,8,4.23,9,14.49
205,199,1,600,604,4,11.46,12.39,13.37
205,199,2,761,767,6,9.79,12.05,14.76
205,199,3,949,964,15,9.87,11.79,14.73
205,201,0,451,458,7,5.26,8.79,13.07
205,201,1,756,786,30,0.23,8.73,14.99
205,202,0,542,549,7,3.06,8.56,14.92
205,202,1,868,876,8,1.87,8.08,14.33
205,202,2,954,958,4,11.39,12.61,14.06
205,203,0,553,564,11,3.08,7.67,12.8
205,203,1,923,946,23,1.12,8.57,13.95
205,204,0,741,751,10,0.58,8.02,14.8
205,204,1,944,949,5,12.5,13.33,14.58
205,206,0,531,537,6,9.46,11.19,13.61
205,206,1,696,708,12,4.92,9,14.69
205,206,2,854,858,4,12.42,13.26,14.1
205,209,0,831,843,12,5.82,9.7,14.98
205,209,1,909,909,0,6.39,6.39,6.39
206,132,0,924,924,0,12.25,12.25,12.25
206,141,0,983,988,5,10.36,11.94,13.86
206,195,0,572,589,17,1.88,8.07,14.84
206,195,1,791,800,9,9.47,10.94,14.08
206,195,2,803,814,11,7.07,9.36,14.01
206,195,3,1028,1037,9,12.76,13.64,14.99
206,196,0,717,740,23,9.83,12.71,14.78
206,196,1,819,825,6,11.49,13.02,14.87
206,196,2,907,914,7,8.06,10.61,14.45
206,196,3,995,1002,7,7.94,10.5,14.34
206,197,0,480,482,2,13.82,14.08,14.38
206,197,1,815,823,8,1.55,7.57,13.48
206,198,0,933,938,5,11.75,12.8,14.29
206,198,1,952,980,28,6.59,9.69,14.23
206,198,2,1021,1030,9,3.96,8.85,14.72
206,199,0,495,507,12,5.14,8.78,13.35
206,199,1,828,835,7,1.14,6.59,12.39
206,199,2,1032,1034,2,14.33,14.54,14.72
206,200,0,606,618,12,3.07,8.32,14.69
206,200,1,926,932,6,11.53,12.87,14.6
206,200,2,958,972,14,2.33,8.07,14.58
206,201,0,668,673,5,10.76,12.37,14.8
206,201,1,905,912,7,4.3,8.7,13.99
206,201,2,1074,1078,4,12.83,13.33,14.32
206,203,0,617,625,8,2.25,7.9,14.88
206,204,0,562,572,10,10.58,12.1,14.25
206,205,0,531,537,6,9.46,11.19,13.61
206,205,1,696,708,12,4.92,9,14.69
206,205,2,854,858,4,12.42,13.26,14.1
206,205,3,1071,1078,7,6.26,9.61,14.75
206,207,0,776,788,12,4.13,8.32,13.43
206,207,1,817,831,14,2.95,8.21,14.84
206,208,0,723,731,8,10.04,12.18,14.93
206,208,1,734,750,16,5.47,9.26,14.41
206,208,2,1042,1055,13,7.06,10.29,14.72
207,196,0,815,830,15,10.44,12.05,14.71
207,197,0,807,822,15,4.91,8.93,14.26
207,197,1,875,898,23,5.72,9.4,14.85
207,197,2,1001,1019,18,7.02,10.05,14.77
207,199,0,535,569,34,4.18,9.18,14.57
207,199,1,832,852,20,4.95,8.9,14.13
207,199,2,961,967,6,13,13.62,14.5
207,200,0,735,753,18,10.55,12.11,14.76
207,200,1,765,778,13,5.42,9.28,14.25
207,200,2,1003,1029,26,1.69,7.31,14.86
207,202,0,717,724,7,10.9,12.17,13.95
207,203,0,1010,1027,17,7.11,10.08,14.56
207,206,0,776,788,12,4.13,8.32,13.43
207,206,1,817,831,14,2.95,8.21,14.84
207,209,0,468,482,14,6.23,9.91,14.65
207,209,1,619,631,12,9.12,11.37,14.73
207,209,2,862,872,10,9.18,11.35,14.62
207,209,3,908,908,0,8.12,8.12,8.12
208,123,0,947,951,4,13.93,14.25,14.58
208,123,1,972,989,17,7.26,9.78,14.73
208,195,0,448,463,15,10.36,12.01,14.65
208,195,1,647,657,10,7.53,10.66,14.91
208,196,0,746,754,8,13.86,14.25,14.96
208,196,1,762,786,24,0.16,7.71,14.95
208,197,0,775,787,12,9.24,11.42,14.69
208,199,0,792,802,10,4.01,8.54,13.68
208,199,1,899,906,7,12.74,13.6,14.81
208,201,0,498,509,11,4.45,8.83,14.42
208,201,1,827,835,8,9.25,11.33,14.71
208,202,0,930,941,11,6.08,9.61,14.6
208,203,0,531,544,13,3.6,8.5,14.27
208,204,0,773,786,13,5.01,9,14.52
208,206,0,723,731,8,10.04,12.18,14.93
208,206,1,734,750,16,5.47,9.26,14.41
208,209,0,429,439,10,1.4,7.89,14.42
208,209,1,584,589,5,11.88,12.84,14.26
208,209,2,687,694,7,11.2,12.74,14.77
208,209,3,792,799,7,10.12,11.96,14.47
209,195,0,723,734,11,11.61,12.64,14.21
209,195,1,910,910,0,4.32,4.32,4.32
209,195,2,1007,1020,13,10.9,12.28,14.52
209,197,0,532,539,7,5.16,8.76,13.5
209,197,1,701,708,7,7.92,10.65,14.48
209,197,2,871,876,5,11.61,12.87,14.72
209,198,0,722,726,4,12.8,13.5,14.39
209,198,1,809,817,8,6.87,10.15,14.22
209,198,2,840,849,9,14.19,14.42,14.8
209,199,0,693,695,2,13.89,14.13,14.27
209,199,1,791,799,8,4.89,8.75,13.87
209,199,2,975,984,9,8.16,10.59,14.3
209,200,0,718,728,10,9.12,11.06,13.93
209,200,1,980,988,8,0.23,7.41,13.48
209,201,0,562,565,3,12.86,13.55,14.55
209,201,1,640,645,5,11.13,12.68,14.94
209,201,2,877,879,2,13.82,14.14,14.37
209,202,0,742,747,5,11.06,12.59,14.52
209,202,1,905,907,2,5.84,9.56,13.28
209,203,0,671,679,8,5.56,9.75,14.52
209,204,0,849,864,15,1.62,7.71,14.14
209,205,0,831,843,12,5.82,9.7,14.98
209,205,1,909,909,0,6.39,6.39,6.39
209,207,0,468,482,14,6.23,9.76,14.65
209,207,1,619,631,12,9.12,11.37,14.73
209,207,2,862,872,10,9.18,11.35,14.62
209,207,3,908,908,0,8.12,8.12,8.12
209,208,0,584,589,5,11.88,12.84,14.26
209,208,1,687,694,7,11.2,12.74,14.77
209,208,2,792,799,7,10.12,11.96,14.47
210,105,0,754,758,4,12.19,13.22,14.46
210,211,0,888,893,5,12.95,13.76,14.76
210,213,0,689,695,6,5.61,8.99,12.97
210,213,1,992,994,2,13.42,13.77,13.97
210,214,0,711,718,7,8.09,10.8,14.28
210,214,1,917,934,17,0.11,7.54,15
210,215,0,602,610,8,5.58,9.59,14.22
210,216,0,523,528,5,11.36,12.66,14.52
210,217,0,617,625,8,2.74,8.46,14.37
210,217,1,1022,1028,6,7.38,9.92,12.98
210,218,0,635,645,10,2.09,7.7,14.12
210,218,1,865,875,10,3.6,8.4,14.38
210,218,2,981,986,5,11.83,13,14.96
210,219,0,592,600,8,1.98,7.99,14.66
210,219,1,686,695,9,1.49,7.66,13.88
210,219,2,897,908,11,10.61,12.35,14.95
210,219,3,971,980,9,1.48,7.65,13.88
210,220,0,517,529,12,9.81,11.57,14.22
210,220,1,538,574,36,3.56,8.99,14.93
210,220,2,1017,1025,8,1.62,8.04,14.51
210,221,0,539,539,0,14.99,14.99,14.99
210,221,1,823,830,7,4.13,8.25,13.31
210,222,0,953,960,7,2.1,6.92,11.88
210,223,0,748,755,7,0.73,7.36,14.15
210,224,0,928,935,7,6.08,9.17,13.06
211,6,0,758,770,12,5.76,9.49,14.52
211,210,0,888,893,5,12.95,13.76,14.76
211,212,0,509,522,13,1.85,7.65,14.26
211,212,1,646,743,97,8.5,10.9,14.98
211,212,2,776,787,11,8,10.49,14.13
211,213,0,564,565,1,14.51,14.56,14.6
211,213,1,653,659,6,9.85,11.51,13.78
211,213,2,663,664,1,14.99,14.99,14.99
211,213,3,1007,1034,27,4.55,9.99,14.89
211,214,0,779,783,4,12.5,13.13,13.87
211,214,1,992,995,3,13.27,13.58,13.88
211,216,0,844,853,9,4.79,8.77,14.04
211,217,0,462,471,9,0.64,7.49,14.53
211,217,1,660,669,9,6.39,10.22,14.98
211,217,2,713,737,24,1.86,7.75,14.67
211,218,0,706,715,9,9.23,11.29,14.52
211,218,1,872,878,6,12.58,13.4,14.43
211,218,2,982,996,14,6.61,9.75,14.5
211,219,0,515,524,9,5.37,8.93,13.4
211,219,1,756,764,8,7.77,10.14,13.21
211,219,2,885,886,1,14.67,14.75,14.83
211,220,0,612,615,3,14.09,14.4,14.77
211,220,1,830,840,10,1.64,7.84,14.79
211,221,0,451,459,8,8.11,10.44,13.75
211,221,1,807,815,8,9.78,11.91,14.74
211,222,0,718,739,21,2.73,7.91,14.21
211,222,1,868,876,8,6.76,9.92,13.86
211,223,0,510,513,3,13.57,13.9,14.29
211,224,0,504,514,10,3.66,8.18,13.71
211,224,1,939,950,11,1.3,7.71,14.14
212,6,0,766,778,12,6.19,9.46,13.96
212,211,0,509,522,13,1.85,7.65,14.26
212,211,1,646,743,97,8.5,10.9,14.98
212,211,2,776,787,11,8,10.49,14.13
212,213,0,554,564,10,3.97,9.09,14.81
212,213,1,941,965,24,2.89,7.55,14.86
212,214,0,768,792,24,4.35,8.56,14.78
212,214,1,899,908,9,1.33,7.14,13
212,217,0,708,727,19,9.84,11.75,14.9
212,217,1,872,880,8,4.91,8.56,12.93
212,218,0,890,903,13,4.36,8.85,14.74
212,219,0,506,528,22,10.72,12.4,14.9
212,219,1,533,548,15,7.07,10.03,14.21
212,219,2,765,770,5,12.79,13.4,14.28
212,221,0,955,964,9,8.49,11.13,14.63
212,222,0,687,688,1,14.89,14.9,14.92
212,222,1,714,734,20,7.7,10.46,14.59
212,223,0,996,1010,14,11.51,12.69,14.71
212,224,0,483,512,29,4.41,10.24,14.6
213,6,0,708,722,14,4.01,7.93,14.73
213,210,0,689,695,6,5.61,8.99,12.97
213,210,1,992,994,2,13.42,13.77,13.97
213,211,0,564,565,1,14.51,14.56,14.6
213,211,1,653,659,6,9.85,11.51,13.78
213,211,2,663,664,1,14.99,14.99,14.99
213,211,3,1007,1034,27,4.55,9.97,14.89
213,212,0,554,564,10,3.97,9.09,14.81
213,212,1,941,965,24,2.89,7.55,14.86
213,214,0,474,501,27,9.69,11.67,14.96
213,214,1,533,542,9,11.95,12.97,14.51
213,214,2,837,841,4,11.57,12.54,13.7
213,214,3,998,1003,5,10.69,12.35,14.49
213,215,0,486,494,8,1.25,7.85,13.88
213,215,1,816,823,7,5.27,9.05,14.22
213,215,2,898,905,7,5.76,9.03,12.95
213,215,3,981,985,4,12.27,13.13,14.24
213,216,0,715,750,35,0.72,7.65,14.73
213,217,0,662,667,5,8.9,10.92,13.61
213,217,1,819,823,4,11.1,12.35,14.12
213,218,0,481,491,10,3.44,8.59,14.51
213,218,1,784,795,11,4.69,9.12,14.69
213,218,2,914,921,7,4.24,8,12.36
213,219,0,685,696,11,8.04,10.48,14.1
213,219,1,825,833,8,7.32,10.47,14.39
213,220,0,623,630,7,1.75,7.35,12.99
213,220,1,708,711,3,13.43,13.96,14.77
213,221,0,685,690,5,11.5,12.72,14.66
213,221,1,901,914,13,4.05,8.68,14.92
213,221,2,1047,1057,10,10.83,12.41,14.86
213,222,0,663,669,6,4.23,8.25,13.22
213,222,1,823,825,2,13.63,13.99,14.27
213,223,0,544,551,7,0.89,7.71,14.61
213,224,0,795,802,7,4.99,8.82,13.8
214,6,0,771,779,8,6.44,9.77,14.22
214,126,0,801,802,1,12.79,13.71,14.63
214,210,0,711,718,7,8.09,10.8,14.28
214,210,1,917,934,17,0.11,7.54,15
214,211,0,779,783,4,12.5,13.13,13.87
214,211,1,992,995,3,13.27,13.58,13.88
214,212,0,768,792,24,4.35,8.78,14.78
214,212,1,899,908,9,1.33,7.14,13
214,213,0,474,501,27,9.69,11.67,14.96
214,213,1,533,542,9,11.95,12.97,14.51
214,213,2,837,841,4,11.57,12.54,13.7
214,213,3,998,1003,5,10.69,12.35,14.49
214,215,0,483,491,8,3.61,8.55,13.85
214,215,1,577,585,8,1.38,7.12,12.75
214,215,2,859,865,6,10.22,11.84,14.51
214,216,0,669,676,7,6.74,9.8,14.22
214,216,1,934,940,6,8.67,10.72,13.22
214,217,0,488,489,1,14.9,14.92,14.93
214,217,1,599,603,4,10.22,11.58,13.05
214,217,2,946,950,4,10.65,11.96,13.73
214,218,0,475,487,12,8.66,11.37,14.36
214,218,1,611,619,8,4.62,8.57,14.61
214,218,2,992,999,7,2.3,7.42,12.79
214,219,0,563,572,9,6.72,9.84,14.27
214,219,1,667,675,8,8.53,10.78,13.76
214,219,2,940,947,7,9.71,11.32,13.58
214,220,0,1025,1029,4,5.27,8.38,13.6
214,221,0,580,590,10,1.98,7.77,14.33
214,222,0,503,509,6,7.57,10.64,14.91
214,223,0,551,555,4,12.97,13.61,14.51
214,223,1,641,650,9,0.66,7.38,14.22
214,223,2,735,741,6,2.9,7.67,12.81
214,224,0,550,559,9,3.19,8.38,14.73
215,126,0,749,766,17,6.92,9.66,14.03
215,210,0,602,610,8,5.58,9.59,14.22
215,213,0,486,494,8,1.25,7.85,13.88
215,213,1,816,823,7,5.27,9.05,14.22
215,213,2,898,905,7,5.76,9.03,12.95
215,213,3,981,985,4,12.27,13.13,14.24
215,214,0,483,491,8,3.61,8.55,13.85
215,214,1,577,585,8,1.38,7.12,12.75
215,214,2,859,865,6,10.22,11.84,14.51
215,216,0,632,681,49,1.76,7.76,14.63
215,217,0,481,486,5,11.14,12.35,14.07
215,217,1,803,847,44,1.77,7.45,14.76
215,218,0,487,495,8,11.36,12.52,14.14
215,218,1,563,571,8,10.34,12.03,14.61
215,218,2,964,975,11,2.32,7.9,14.55
215,219,0,655,664,9,12.7,13.58,14.93
215,219,1,850,853,3,13.97,14.35,14.92
215,221,0,472,480,8,6.36,9.37,13.23
215,221,1,579,586,7,9.02,11.33,14.73
215,221,2,897,903,6,9.48,11.23,13.48
215,222,0,470,472,2,14.1,14.36,14.65
215,222,1,968,978,10,12.34,13.32,14.75
215,224,0,618,623,5,12.52,13.33,14.35
215,224,1,712,722,10,3.67,8.88,14.74
215,318,0,694,694,0,8.37,8.37,8.37
215,318,1,800,802,2,13.47,14.12,14.77
216,6,0,709,711,2,13.83,14.41,14.98
216,126,0,706,720,14,1.93,7.92,14.98
216,210,0,523,528,5,11.36,12.66,14.52
216,211,0,844,853,9,4.79,8.77,14.04
216,213,0,715,750,35,0.72,7.65,14.73
216,214,0,669,676,7,6.74,9.8,14.22
216,214,1,934,940,6,8.67,10.72,13.22
216,215,0,632,681,49,1.76,7.76,14.63
216,217,0,577,578,1,14.82,14.84,14.86
216,217,1,908,916,8,1.74,7.83,14.82
216,218,0,810,826,16,1.3,8.78,14.67
216,219,0,431,448,17,1.45,7.64,14.61
216,219,1,653,671,18,9.88,11.81,14.87
216,219,2,936,944,8,5.85,9.73,14.56
216,220,0,521,527,6,8.47,10.59,13.46
216,220,1,706,713,7,5.48,8.81,12.83
216,220,2,891,899,8,2.27,7.88,14.23
216,221,0,780,788,8,6.91,10.05,14.85
216,221,1,1014,1032,18,0.78,6.22,14.31
216,222,0,747,750,3,13.38,13.99,14.91
216,222,1,921,927,6,9.55,11.71,14.48
216,223,0,440,444,4,11.86,12.81,13.81
216,223,1,615,621,6,9.73,11.83,14.48
216,224,0,1009,1032,23,8.77,12.57,14.99
217,6,0,740,752,12,9.42,11.46,14.98
217,210,0,617,625,8,2.74,8.46,14.37
217,210,1,1022,1028,6,7.38,9.92,12.98
217,211,0,462,471,9,0.64,7.49,14.53
217,211,1,660,669,9,6.39,10.22,14.98
217,211,2,713,737,24,1.86,7.75,14.67
217,212,0,708,727,19,9.84,11.75,14.9
217,212,1,872,880,8,4.91,8.56,12.93
217,213,0,662,667,5,8.9,10.92,13.61
217,213,1,819,823,4,11.1,12.35,14.12
217,214,0,488,489,1,14.9,14.92,14.93
217,214,1,599,603,4,10.22,11.58,13.05
217,214,2,946,950,4,10.65,11.96,13.73
217,215,0,481,486,5,11.14,12.35,14.07
217,215,1,803,847,44,1.77,7.52,14.76
217,216,0,577,578,1,14.82,14.84,14.86
217,216,1,908,916,8,1.74,7.83,14.82
217,218,0,587,596,9,9.09,12.09,14.56
217,219,0,848,857,9,5.06,8.98,13.89
217,219,1,1043,1048,5,10.52,12.23,14.68
217,220,0,902,908,6,6.38,9.58,13.07
217,221,0,986,992,6,6.02,9.32,13.64
217,222,0,583,590,7,2.78,8.53,14.86
217,222,1,659,772,113,1.56,8.92,14.96
217,223,0,718,721,3,12.99,13.76,14.88
217,223,1,895,904,9,3.64,8.73,14.48
217,223,2,1052,1059,7,2.56,8.11,14.64
217,224,0,460,460,0,13.01,13.01,13.01
217,224,1,633,636,3,12.8,13.31,13.96
218,105,0,797,802,5,9.68,11.35,13.59
218,210,0,635,645,10,2.09,7.7,14.12
218,210,1,865,875,10,3.6,8.4,14.38
218,210,2,981,986,5,11.83,13,14.96
218,211,0,706,715,9,9.23,11.29,14.52
218,211,1,872,878,6,12.58,13.4,14.43
218,211,2,982,996,14,6.61,9.75,14.5
218,212,0,890,903,13,4.36,8.85,14.74
218,213,0,481,491,10,3.44,8.59,14.51
218,213,1,784,795,11,4.69,9.12,14.69
218,213,2,914,921,7,4.24,8,12.36
218,214,0,478,487,9,8.66,10.57,13.87
218,214,1,610,619,9,4.62,9.09,14.61
218,214,2,992,999,7,2.3,7.42,12.79
218,215,0,487,495,8,11.36,12.52,14.14
218,215,1,563,571,8,10.34,12.03,14.61
218,215,2,964,975,11,2.32,7.9,14.55
218,216,0,810,826,16,1.3,8.76,14.67
218,217,0,587,596,9,9.09,11.93,14.56
218,219,0,701,708,7,6.1,9.57,13.9
218,220,0,762,765,3,13.64,14,14.46
218,220,1,792,805,13,4.15,8.42,13.9
218,222,0,586,596,10,8.82,10.99,14.37
218,222,1,874,882,8,5.67,9.3,14.31
218,222,2,970,976,6,5.42,8.69,12.6
218,223,0,523,530,7,7.39,10.68,14.74
218,223,1,793,800,7,6.96,10.42,14.86
218,224,0,529,538,9,10.19,12.07,14.98
218,224,1,760,776,16,6.65,10.66,14.27
219,6,0,753,768,15,3.24,8.33,14.93
219,105,0,717,727,10,1.78,7.54,13.25
219,210,0,592,600,8,1.98,7.99,14.66
219,210,1,686,695,9,1.49,7.66,13.88
219,210,2,897,908,11,10.61,12.35,14.95
219,210,3,971,980,9,1.48,7.65,13.88
219,211,0,515,524,9,5.37,8.93,13.4
219,211,1,756,764,8,7.77,10.14,13.21
219,211,2,885,886,1,14.67,14.75,14.83
219,212,0,506,528,22,10.72,12.46,14.9
219,212,1,533,548,15,7.07,10.03,14.21
219,212,2,765,770,5,12.79,13.4,14.28
219,213,0,685,696,11,8.04,10.48,14.1
219,213,1,825,833,8,7.32,10.51,14.39
219,214,0,563,572,9,6.72,9.84,14.27
219,214,1,667,675,8,8.53,10.78,13.76
219,214,2,940,947,7,9.71,11.32,13.58
219,215,0,655,664,9,12.7,13.58,14.93
219,215,1,850,853,3,13.97,14.35,14.92
219,216,0,653,671,18,9.88,11.81,14.87
219,216,1,936,944,8,5.85,9.73,14.56
219,217,0,848,857,9,5.06,8.98,13.89
219,217,1,1043,1048,5,10.52,12.23,14.68
219,218,0,701,708,7,6.1,9.57,13.9
219,221,0,681,688,7,1.17,7.27,13.37
219,222,0,812,821,9,5.9,9.42,14.34
219,223,0,449,463,14,10.95,12.83,14.73
219,223,1,498,508,10,4.31,8.66,13.92
219,223,2,603,614,11,4.18,9.07,14.91
219,223,3,709,719,10,4.33,8.67,14.17
219,223,4,815,825,10,4.04,8.5,14.09
219,223,5,920,931,11,4.44,8.75,14.99
219,223,6,1026,1037,11,5.21,9.96,14.98
219,224,0,506,508,2,14.48,14.71,15
220,6,0,708,713,5,8.83,11.06,14.08
220,105,0,791,800,9,10.51,12.36,14.78
220,126,0,696,713,17,1.15,7.01,14.34
220,210,0,517,529,12,9.81,11.57,14.22
220,210,1,538,574,36,3.56,8.99,14.93
220,210,2,1017,1025,8,1.62,8.04,14.51
220,211,0,612,615,3,14.09,14.4,14.77
220,211,1,830,840,10,1.64,7.84,14.79
220,212,0,437,452,15,3.18,8.11,14.08
220,213,0,623,630,7,1.75,7.35,12.99
220,213,1,708,711,3,13.43,13.96,14.77
220,214,0,1025,1035,10,5.27,9.39,14.19
220,216,0,521,527,6,8.47,10.59,13.46
220,216,1,706,713,7,5.48,8.81,12.83
220,216,2,891,899,8,2.27,7.88,14.23
220,217,0,433,437,4,7.55,10.79,14.13
220,217,1,902,908,6,6.38,9.58,13.07
220,218,0,762,765,3,13.64,14,14.46
220,218,1,792,805,13,4.15,8.42,13.9
220,221,0,537,544,7,3,8.08,14.14
220,221,1,646,656,10,6.23,9.66,14.08
220,223,0,480,486,6,7.3,10.27,13.54
220,223,1,582,588,6,4.41,8.29,12.64
220,223,2,686,696,10,3.41,8.21,13.84
220,223,3,792,800,8,8.74,10.89,13.79
220,224,0,586,590,4,12.2,12.99,14.06
220,224,1,743,775,32,8.84,11.05,14.69
220,224,2,910,927,17,2.41,8.07,14.49
221,210,0,539,539,0,14.99,14.99,14.99
221,210,1,823,830,7,4.13,8.25,13.31
221,211,0,451,459,8,8.11,10.44,13.75
221,211,1,807,815,8,9.78,11.91,14.74
221,212,0,955,964,9,8.49,11.13,14.63
221,213,0,685,690,5,11.5,12.72,14.66
221,213,1,901,914,13,4.05,8.68,14.92
221,214,0,580,590,10,1.98,7.77,14.33
221,215,0,472,480,8,6.36,9.37,13.23
221,215,1,579,586,7,9.02,11.33,14.73
221,215,2,897,903,6,9.48,11.23,13.48
221,216,0,780,788,8,6.91,10.05,14.85
221,216,1,1014,1037,23,0.78,7.15,14.31
221,217,0,986,992,6,6.02,9.32,13.64
221,219,0,681,688,7,1.17,7.27,13.37
221,220,0,537,544,7,3,8.08,14.14
221,220,1,646,656,10,6.23,9.66,14.08
221,222,0,466,475,9,3.76,8.11,13.38
221,223,0,973,983,10,4.35,9.27,14.82
221,224,0,446,448,2,7.55,10.25,12.96
221,224,1,1004,1038,34,5.39,10.3,14.56
222,126,0,779,783,4,13.26,13.91,14.58
222,210,0,953,960,7,2.1,6.92,11.88
222,211,0,718,739,21,2.73,7.91,14.21
222,211,1,868,876,8,6.76,9.92,13.86
222,212,0,687,688,1,14.89,14.9,14.92
222,212,1,714,734,20,7.7,10.46,14.59
222,213,0,663,669,6,4.23,8.25,13.22
222,213,1,823,825,2,13.63,13.99,14.27
222,214,0,503,509,6,7.57,10.64,14.91
222,215,0,470,472,2,14.1,14.36,14.65
222,215,1,968,978,10,12.34,13.32,14.75
222,216,0,747,750,3,13.38,13.99,14.91
222,216,1,921,927,6,9.55,11.71,14.48
222,217,0,583,589,6,2.78,7.63,13.52
222,217,1,659,772,113,1.56,8.94,14.96
222,218,0,449,454,5,11.87,12.8,14.62
222,218,1,586,596,10,8.82,10.99,14.37
222,218,2,874,882,8,5.67,9.3,14.31
222,218,3,970,976,6,5.42,8.69,12.6
222,219,0,812,821,9,5.9,9.42,14.34
222,221,0,466,475,9,3.76,8.11,13.38
222,223,0,720,722,2,13.42,13.81,14.13
222,223,1,815,821,6,2.22,7.48,12.38
222,224,0,632,639,7,7.43,10.36,14.04
222,224,1,820,827,7,9.13,11.3,14.5
223,105,0,781,790,9,1.87,7.54,13.6
223,210,0,748,755,7,0.73,7.36,14.15
223,211,0,510,513,3,13.57,13.9,14.29
223,212,0,996,1010,14,11.51,12.69,14.71
223,213,0,544,551,7,0.89,7.71,14.61
223,214,0,551,555,4,12.97,13.61,14.51
223,214,1,641,650,9,0.66,7.38,14.22
223,214,2,735,741,6,2.9,7.67,12.81
223,216,0,440,444,4,11.86,12.81,13.81
223,216,1,615,621,6,9.73,11.83,14.48
223,217,0,718,721,3,12.99,13.76,14.88
223,217,1,895,904,9,3.64,8.73,14.48
223,218,0,523,530,7,7.39,10.68,14.74
223,218,1,793,800,7,6.96,10.42,14.86
223,219,0,441,463,22,9.9,12.27,14.73
223,219,1,498,508,10,4.31,8.66,13.92
223,219,2,603,614,11,4.18,9.07,14.91
223,219,3,709,719,10,4.33,8.67,14.17
223,219,4,815,825,10,4.04,8.5,14.09
223,219,5,920,931,11,4.44,9.35,14.99
223,219,6,1027,1030,3,5.21,7.79,10.73
223,220,0,480,486,6,7.3,10.27,13.54
223,220,1,582,588,6,4.41,8.29,12.64
223,220,2,686,696,10,3.41,8.21,13.84
223,220,3,792,800,8,8.74,10.89,13.79
223,221,0,973,983,10,4.35,9.27,14.82
223,222,0,720,722,2,13.42,13.81,14.13
223,222,1,815,821,6,2.22,7.48,12.38
223,224,0,508,523,15,1.98,7.79,14.32
223,224,1,556,586,30,4.87,9.09,14.9
223,224,2,658,670,12,9.26,11.43,14.64
223,224,3,876,883,7,9.45,11.45,14.14
224,210,0,928,935,7,6.08,9.17,13.06
224,211,0,504,514,10,3.66,8.18,13.71
224,211,1,939,950,11,1.3,7.71,14.14
224,212,0,483,512,29,4.41,10.23,14.6
224,213,0,795,802,7,4.99,8.82,13.8
224,214,0,550,559,9,3.19,8.38,14.73
224,215,0,618,623,5,12.52,13.33,14.35
224,215,1,712,722,10,3.67,8.88,14.74
224,216,0,1009,1036,27,3.61,11.49,14.99
224,217,0,443,460,17,3.72,8.12,14.92
224,217,1,633,636,3,12.8,13.31,13.96
224,218,0,529,538,9,10.19,12.07,14.98
224,218,1,760,776,16,6.65,10.56,14.27
224,219,0,506,508,2,14.48,14.71,15
224,220,0,586,590,4,12.2,12.99,14.06
224,220,1,743,775,32,8.84,11.06,14.69
224,220,2,910,927,17,2.41,8.07,14.49
224,221,0,434,448,14,3.65,7.77,13.34
224,221,1,1004,1036,32,5.39,10.05,14.56
224,222,0,632,639,7,7.43,10.36,14.04
224,222,1,820,827,7,9.13,11.3,14.5
224,223,0,508,523,15,1.98,7.79,14.32
224,223,1,556,586,30,4.87,9.09,14.9
224,223,2,658,670,12,9.26,11.43,14.64
224,223,3,876,883,7,9.45,11.45,14.14
225,226,0,653,674,21,6.23,9.7,14.67
225,227,0,835,835,0,14.42,14.42,14.42
225,227,1,1007,1009,2,14.33,14.54,14.83
225,228,0,466,474,8,2.61,7.66,13.42
225,228,1,558,558,0,14.8,14.8,14.8
225,228,2,818,825,7,1.6,7.99,14.38
225,228,3,925,936,11,1.43,7.71,14.45
225,228,4,1036,1050,14,0.66,7.55,14.06
225,229,0,478,488,10,0.22,7.13,13.18
225,229,1,673,684,11,5.8,9.27,13.77
225,229,2,804,805,1,14.76,14.84,14.91
225,229,3,915,922,7,6.63,9.9,14.6
225,230,0,593,618,25,4.41,9.17,14.49
225,230,1,642,654,12,9.62,11.71,14.91
225,231,0,497,505,8,2.39,8.21,14.77
225,231,1,827,834,7,5.74,9.31,14.06
225,231,2,929,936,7,12.63,13.31,14.27
225,231,3,1076,1079,3,12.84,13.7,14.82
225,232,0,507,514,7,6.27,9.86,14.78
225,233,0,516,531,15,5.3,9.24,14.73
225,234,0,482,490,8,7.19,9.95,13.84
225,234,1,783,788,5,11.13,12.51,14.8
225,235,0,829,836,7,11.37,12.64,14.73
225,236,0,465,466,1,14.32,14.5,14.69
225,236,1,611,654,43,3.34,9.37,14.89
225,236,2,712,718,6,5.8,9.33,14.64
225,236,3,962,968,6,3.38,7.93,12.81
225,237,0,508,518,10,9.94,12.04,14.94
225,238,0,758,765,7,2.71,8.1,14.58
225,238,1,939,946,7,10.15,12.2,14.89
225,239,0,499,507,8,4.17,8.7,13.76
225,239,1,546,558,12,1.75,8,14.66
225,239,2,671,675,4,11.28,12.52,14.2
226,225,0,653,674,21,6.23,9.7,14.67
226,227,0,553,559,6,12.6,13.59,14.95
226,227,1,970,985,15,11.4,12.71,14.77
226,227,2,988,999,11,9.65,11.75,14.84
226,228,0,703,707,4,14.6,14.7,14.86
226,228,1,892,895,3,14.11,14.45,14.95
226,229,0,682,695,13,10.45,12,14.54
226,231,0,893,898,5,12.96,13.66,14.64
226,232,0,593,610,17,3.86,8.4,14.06
226,232,1,892,907,15,4.86,9.11,14.54
226,234,0,857,860,3,14.32,14.51,14.76
226,235,0,499,505,6,14.1,14.45,14.97
226,235,1,534,581,47,6.7,9.54,14.72
226,236,0,733,744,11,1.08,7.19,13.86
226,238,0,604,620,16,4.41,8.77,14.21
226,238,1,833,851,18,2.26,8.1,14.6
226,238,2,918,930,12,5.14,9.06,14.78
226,238,3,1044,1056,12,4.99,8.97,14.6
226,239,0,672,682,10,2.07,7.85,14.25
227,33,0,769,769,0,11.25,11.25,11.25
227,34,0,811,814,3,8.91,11.09,13.4
227,41,0,814,814,0,12.22,12.22,12.22
227,56,0,769,769,0,7.92,7.92,7.92
227,225,0,835,835,0,14.42,14.42,14.42
227,225,1,1007,1009,2,14.33,14.54,14.83
227,226,0,553,559,6,12.6,13.59,14.95
227,226,1,970,985,15,11.4,12.71,14.77
227,226,2,988,999,11,9.65,11.75,14.84
227,228,0,917,923,6,6.75,10.1,14.67
227,229,0,623,639,16,2.21,7.77,13.92
227,229,1,834,834,0,10.78,10.78,10.78
227,229,2,902,913,11,1,7.78,14.89
227,230,0,834,834,0,11.36,11.36,11.36
227,231,0,630,681,51,9.85,11.72,14.9
227,231,1,688,692,4,12.68,13.75,14.89
227,231,2,835,835,0,12.95,12.95,12.95
227,231,3,915,925,10,4.44,9.96,14.38
227,232,0,451,469,18,6.94,9.67,14.37
227,233,0,973,978,5,12.6,13.42,14.55
227,235,0,453,461,8,3.07,7.74,12.85
227,235,1,738,746,8,5.57,9.2,13.59
227,235,2,836,836,0,6.25,6.25,6.25
227,236,0,514,516,2,13.64,13.99,14.35
227,237,0,859,864,5,13.9,14.36,14.93
227,238,0,702,713,11,7.42,9.96,13.44
227,238,1,1025,1032,7,1.9,7.73,14.3
227,239,0,703,706,3,13.53,13.95,14.43
228,225,0,466,474,8,2.61,7.66,13.42
228,225,1,558,558,0,14.8,14.8,14.8
228,225,2,818,825,7,1.6,7.99,14.38
228,225,3,925,936,11,1.43,7.71,14.45
228,226,0,703,707,4,14.6,14.7,14.86
228,226,1,892,895,3,14.11,14.45,14.95
228,227,0,917,923,6,6.75,10.1,14.67
228,230,0,801,815,14,1.04,7.49,14.6
228,230,1,845,865,20,3.33,9.1,14.37
228,231,0,516,521,5,10.04,11.55,13.5
228,231,1,912,946,34,7.99,12.48,14.9
228,231,2,975,992,17,0.59,7.59,14.77
228,234,0,505,511,6,9.61,11.59,14.55
228,234,1,985,987,2,14.58,14.78,14.99
228,235,0,938,945,7,8.86,11.46,14.78
228,236,0,452,465,13,4.13,9.04,14.75
228,236,1,722,729,7,6.45,9.75,13.75
228,237,0,985,1001,16,5.04,9.66,14.99
228,238,0,678,686,8,8.77,11.47,14.85
228,238,1,775,779,4,11.87,12.9,14.21
228,238,2,1008,1018,10,8.11,10.75,14.24
228,239,0,595,595,0,14.79,14.79,14.79
228,239,1,684,690,6,4.95,8.72,13.17
229,225,0,478,488,10,0.22,7.13,13.18
229,225,1,673,684,11,5.8,9.27,13.77
229,225,2,804,805,1,14.76,14.84,14.91
229,225,3,915,922,7,6.63,9.9,14.6
229,226,0,682,695,13,10.45,12,14.54
229,227,0,623,639,16,2.21,7.77,13.92
229,227,1,834,834,0,10.78,10.78,10.78
229,227,2,902,913,11,1,7.78,14.89
229,230,0,503,518,15,11.82,12.86,14.62
229,230,1,834,837,3,14.22,14.41,14.64
229,231,0,631,645,14,1.59,7.73,14.24
229,231,1,890,896,6,14.46,14.68,14.97
229,232,0,881,885,4,14.11,14.44,14.94
229,233,0,852,862,10,6.66,9.87,14.68
229,234,0,482,492,10,2.45,7.87,13.9
229,234,1,889,903,14,1.19,7.93,14.73
229,236,0,989,996,7,9.59,11.89,14.86
229,237,0,689,708,19,9.6,11.6,14.44
229,238,0,507,526,19,1.39,7.75,14.98
229,239,0,491,498,7,9.37,11.38,14.03
229,239,1,574,590,16,0.94,7.43,13.87
230,225,0,593,618,25,4.41,8.96,14.49
230,225,1,642,654,12,9.62,11.71,14.91
230,227,0,834,834,0,11.36,11.36,11.36
230,228,0,801,815,14,1.04,7.49,14.6
230,228,1,845,865,20,3.33,8.96,14.37
230,229,0,503,518,15,11.82,12.86,14.62
230,229,1,834,837,3,14.22,14.41,14.64
230,231,0,441,447,6,13.04,13.78,14.71
230,231,1,818,828,10,4.9,9.18,14.8
230,231,2,946,958,12,3.73,8.48,14.54
230,232,0,621,630,9,9.17,11.45,14.64
230,233,0,492,505,13,4.7,8.85,14.39
230,233,1,685,694,9,11.41,12.71,14.57
230,234,0,468,477,9,11.92,12.98,14.64
230,235,0,811,822,11,6.26,9.97,14.77
230,235,1,941,951,10,9.29,11.38,14.73
230,236,0,606,624,18,5.31,9.32,14.83
230,236,1,643,655,12,1.87,7.46,13.4
230,236,2,1024,1033,9,2.11,7.41,13.07
230,238,0,517,557,40,2.47,7.96,14.65
230,238,1,570,578,8,9.23,11.41,14.64
230,238,2,671,679,8,8.45,11,14.87
230,238,3,937,958,21,7.78,10.54,14.9
230,239,0,489,494,5,11.58,12.71,14.51
231,225,0,497,505,8,2.39,8.21,14.77
231,225,1,827,834,7,5.74,9.31,14.06
231,225,2,929,936,7,12.63,13.31,14.27
231,226,0,893,898,5,12.96,13.66,14.64
231,227,0,630,681,51,9.85,11.72,14.9
231,227,1,688,692,4,12.68,13.75,14.89
231,227,2,835,835,0,12.95,12.95,12.95
231,227,3,915,925,10,4.44,10.21,14.38
231,228,0,516,521,5,10.04,11.55,13.5
231,228,1,912,946,34,7.99,12.48,14.9
231,228,2,975,992,17,0.59,7.59,14.77
231,229,0,631,645,14,1.59,7.73,14.24
231,229,1,890,896,6,14.46,14.68,14.97
231,230,0,441,447,6,13.04,13.78,14.71
231,230,1,818,828,10,4.9,9.18,14.8
231,230,2,946,958,12,3.73,8.48,14.54
231,232,0,560,567,7,7.54,10.01,13.15
231,232,1,877,895,18,2.6,8.28,14.92
231,234,0,432,446,14,5.93,9.74,14.9
231,234,1,537,541,4,12.72,13.43,14.41
231,234,2,553,586,33,10.4,12.04,14.91
231,234,3,626,634,8,5.87,9.4,14.82
231,234,4,714,723,9,1.45,7.84,14.62
231,234,5,805,812,7,8.61,11.02,14.89
231,234,6,985,991,6,9.33,11.25,14.08
231,235,0,818,825,7,14.43,14.63,14.99
231,235,1,942,950,8,5.23,9.28,13.84
231,237,0,450,462,12,7.34,10.47,14.8
231,237,1,986,999,13,9.59,11.77,14.75
231,238,0,481,496,15,7.11,10.19,14.56
231,238,1,715,737,22,3.31,9.17,14.67
231,238,2,950,967,17,0.4,7.53,14.96
231,239,0,500,507,7,5.46,9.32,14.35
232,225,0,507,514,7,6.27,9.86,14.78
232,226,0,593,610,17,3.86,8.4,14.06
232,226,1,892,907,15,4.86,9.11,14.54
232,227,0,444,469,25,6.94,10.46,14.37
232,229,0,881,885,4,14.11,14.44,14.94
232,230,0,621,630,9,9.17,11.45,14.64
232,231,0,560,567,7,7.54,10.01,13.15
232,231,1,877,895,18,2.6,8.28,14.92
232,233,0,750,753,3,13.75,14.02,14.31
232,234,0,556,567,11,2.92,8.13,14.42
232,235,0,450,459,9,1.31,7.49,13.98
232,235,1,584,587,3,14.01,14.36,14.81
232,235,2,720,730,10,10.05,11.82,14.94
232,236,0,619,621,2,14.01,14.3,14.58
232,237,0,497,518,21,3.84,8.54,14.81
232,237,1,1055,1055,0,13.83,13.83,13.83
232,238,0,602,610,8,4.17,8.6,14.69
232,238,1,1017,1026,9,6.87,10,14.4
232,239,0,513,521,8,0.97,7.82,14.16
233,225,0,516,531,15,5.3,9.24,14.73
233,227,0,973,978,5,12.6,13.42,14.55
233,229,0,852,862,10,6.66,9.87,14.68
233,230,0,492,505,13,4.7,8.85,14.39
233,230,1,685,694,9,11.41,12.71,14.57
233,232,0,750,753,3,13.75,14.02,14.31
233,234,0,828,838,10,6.13,9.69,14.6
233,235,0,1015,1026,11,1.32,7.58,13.9
233,236,0,831,839,8,4.72,8.56,13
233,236,1,925,932,7,6.97,9.74,13.32
233,237,0,581,611,30,1.49,7.66,14.64
233,238,0,505,513,8,9.59,11.73,14.54
233,238,1,652,664,12,3.89,8.4,13.78
233,239,0,471,488,17,0.97,6.76,14.07
233,239,1,528,532,4,13.9,14.25,14.69
234,225,0,482,490,8,7.19,9.95,13.84
234,225,1,783,788,5,11.13,12.51,14.8
234,226,0,857,860,3,14.32,14.51,14.76
234,228,0,505,511,6,9.61,11.59,14.55
234,228,1,985,987,2,14.58,14.78,14.99
234,229,0,482,492,10,2.45,7.87,13.9
234,229,1,889,903,14,1.19,7.93,14.73
234,230,0,468,477,9,11.92,12.98,14.64
234,231,0,537,541,4,12.72,13.43,14.41
234,231,1,553,586,33,10.4,12.04,14.91
234,231,2,626,634,8,5.87,9.4,14.82
234,231,3,714,723,9,1.45,7.84,14.62
234,231,4,805,812,7,8.61,11.02,14.89
234,231,5,985,991,6,9.33,11.25,14.08
234,232,0,556,567,11,2.92,8.13,14.42
234,233,0,828,838,10,6.13,9.69,14.6
234,235,0,794,805,11,7.78,10.62,14.72
234,235,1,923,931,8,9.23,11.44,14.33
234,236,0,833,851,18,3.21,8.18,14.39
234,238,0,711,722,11,6.86,9.8,13.97
234,238,1,853,862,9,6.48,10.12,14.82
234,239,0,620,621,1,14.75,14.82,14.9
234,239,1,741,743,2,14.01,14.24,14.5
235,225,0,829,836,7,11.37,12.64,14.73
235,226,0,499,505,6,14.1,14.45,14.97
235,226,1,534,581,47,6.7,9.59,14.72
235,227,0,453,461,8,3.07,7.74,12.85
235,227,1,738,746,8,5.57,9.2,13.59
235,227,2,836,836,0,6.25,6.25,6.25
235,228,0,938,945,7,8.86,11.46,14.78
235,228,1,1079,1079,0,14.28,14.28,14.28
235,230,0,811,822,11,6.26,9.97,14.77
235,230,1,941,951,10,9.29,11.38,14.73
235,231,0,818,825,7,14.43,14.63,14.99
235,231,1,942,950,8,5.23,9.28,13.84
235,232,0,450,459,9,1.31,7.49,13.98
235,232,1,584,587,3,14.01,14.36,14.81
235,232,2,720,730,10,10.05,11.82,14.94
235,233,0,1015,1026,11,1.32,7.58,13.9
235,234,0,794,805,11,7.78,10.62,14.72
235,234,1,923,931,8,9.23,11.44,14.33
235,237,0,635,658,23,4.63,8.34,14.84
235,237,1,879,893,14,8.75,11.04,14.63
235,238,0,438,450,12,8.77,10.24,13.27
235,238,1,947,947,0,14.86,14.86,14.86
235,239,0,651,655,4,12.56,13.41,14.75
236,225,0,465,466,1,14.32,14.5,14.69
236,225,1,611,654,43,3.34,9.4,14.89
236,225,2,712,718,6,5.8,9.33,14.64
236,225,3,962,968,6,3.38,7.93,12.81
236,226,0,733,744,11,1.08,6.97,13.86
236,227,0,514,516,2,13.64,13.99,14.35
236,228,0,458,465,7,4.13,8.77,14.75
236,228,1,722,729,7,6.45,9.75,13.75
236,229,0,989,996,7,9.59,11.89,14.86
236,230,0,606,624,18,5.31,9.32,14.83
236,230,1,643,655,12,1.87,7.46,13.4
236,230,2,1024,1033,9,2.11,7.41,13.07
236,232,0,619,621,2,14.01,14.3,14.58
236,233,0,462,463,1,14.96,14.97,14.98
236,233,1,831,839,8,4.72,8.56,13
236,233,2,925,932,7,6.97,9.74,13.32
236,234,0,833,851,18,3.21,8.18,14.39
236,234,1,1046,1051,5,6.68,10.14,14.19
236,237,0,748,762,14,8.28,11.05,14.94
236,238,0,864,879,15,9.31,11.37,14.72
236,239,0,867,875,8,7.18,10.03,13.87
237,225,0,508,518,10,9.94,12.04,14.94
237,227,0,859,864,5,13.9,14.36,14.93
237,228,0,985,1001,16,5.04,9.69,14.99
237,229,0,689,708,19,9.6,11.58,14.44
237,231,0,450,462,12,7.34,10.47,14.8
237,231,1,986,999,13,9.59,11.76,14.75
237,232,0,497,518,21,3.84,8.54,14.81
237,232,1,1055,1059,4,13.83,13.9,13.97
237,233,0,581,611,30,1.49,7.66,14.64
237,235,0,635,658,23,4.63,8.39,14.84
237,235,1,879,893,14,8.75,11.04,14.63
237,236,0,748,762,14,8.28,11.05,14.94
237,238,0,463,479,16,4.58,8.69,14.09
237,238,1,495,495,0,14.99,14.99,14.99
237,239,0,517,527,10,8.78,11,14.24
237,239,1,649,667,18,5.74,9.53,14.68
238,225,0,758,765,7,2.71,8.1,14.58
238,225,1,939,946,7,10.15,12.2,14.89
238,226,0,604,620,16,4.41,8.77,14.21
238,226,1,833,851,18,2.26,8.37,14.6
238,226,2,918,930,12,5.14,9.06,14.78
238,226,3,1044,1056,12,4.99,8.97,14.6
238,226,4,1063,1065,2,10.5,12.28,14.06
238,227,0,702,713,11,7.42,9.96,13.44
238,227,1,1025,1032,7,1.9,7.73,14.3
238,228,0,678,686,8,8.77,11.47,14.85
238,228,1,775,779,4,11.87,12.9,14.21
238,228,2,1008,1018,10,8.11,10.75,14.24
238,229,0,507,526,19,1.39,7.75,14.98
238,230,0,517,557,40,2.47,7.96,14.65
238,230,1,570,578,8,9.23,11.41,14.64
238,230,2,671,679,8,8.45,11,14.87
238,230,3,937,958,21,7.78,10.54,14.9
238,231,0,481,496,15,7.11,10.31,14.56
238,231,1,715,737,22,3.31,9.37,14.67
238,231,2,950,967,17,0.4,7.53,14.96
238,232,0,602,610,8,4.17,8.6,14.69
238,232,1,1017,1026,9,6.87,10,14.4
238,233,0,505,513,8,9.59,11.73,14.54
238,233,1,652,664,12,3.89,8.4,13.78
238,234,0,711,722,11,6.86,9.8,13.97
238,234,1,853,862,9,6.48,10.12,14.82
238,235,0,446,450,4,8.77,10.43,13.27
238,235,1,947,947,0,14.86,14.86,14.86
238,236,0,864,879,15,9.31,11.37,14.72
238,237,0,463,479,16,4.58,8.69,14.09
238,237,1,495,495,0,14.99,14.99,14.99
238,239,0,689,699,10,12.89,13.71,14.9
239,225,0,499,507,8,4.17,8.7,13.76
239,225,1,546,558,12,1.75,8,14.66
239,225,2,671,675,4,11.28,12.52,14.2
239,226,0,672,682,10,2.07,7.85,14.25
239,227,0,703,706,3,13.53,13.95,14.43
239,228,0,595,595,0,14.79,14.79,14.79
239,228,1,684,690,6,4.95,8.72,13.17
239,229,0,491,498,7,9.37,11.38,14.03
239,229,1,574,590,16,0.94,7.24,13.87
239,230,0,489,494,5,11.58,12.71,14.51
239,231,0,500,507,7,5.46,9.32,14.35
239,232,0,513,521,8,0.97,7.82,14.16
239,233,0,469,488,19,0.97,7.39,14.07
239,233,1,528,532,4,13.9,14.25,14.69
239,234,0,620,621,1,14.75,14.82,14.9
239,234,1,741,743,2,14.01,14.24,14.5
239,235,0,651,655,4,12.56,13.41,14.75
239,236,0,867,875,8,7.18,10.03,13.87
239,237,0,517,527,10,8.78,11,14.24
239,237,1,649,667,18,5.74,9.54,14.68
239,238,0,689,699,10,12.89,13.71,14.9
239,277,0,1028,1066,38,0.25,7.65,14.94
239,339,0,1001,1009,8,13.42,13.93,14.87
240,241,0,477,516,39,1.66,7.52,14.63
240,241,1,598,606,8,3.78,8.5,14.61
240,241,2,847,859,12,12.22,13.15,14.6
240,242,0,538,543,5,13.47,14.02,14.85
240,243,0,1003,1010,7,9.64,11.55,14.43
240,243,1,1017,1033,16,2.29,8.21,14.79
240,244,0,454,460,6,3.15,7.05,13.72
240,244,1,626,633,7,12.83,13.6,14.98
240,244,2,769,774,5,11.61,12.85,14.48
240,245,0,470,471,1,14.93,14.96,14.98
240,245,1,565,577,12,5.28,8.91,13.74
240,245,2,754,766,12,6.63,9.84,14.29
240,246,0,540,546,6,9.32,11.28,13.6
240,246,1,901,914,13,8.43,10.66,13.91
240,246,2,956,963,7,7.99,10.68,14.31
240,247,0,460,470,10,10.68,12.23,14.71
240,247,1,525,526,1,14.69,14.81,14.93
240,247,2,807,816,9,11.07,12.54,14.84
240,247,3,879,883,4,11.74,12.63,13.53
240,248,0,454,454,0,14.97,14.97,14.97
240,248,1,758,765,7,3.79,8.86,14.94
240,249,0,634,640,6,8.11,10.54,13.8
240,250,0,540,551,11,4.09,8.34,13.67
240,250,1,789,793,4,13.86,14.2,14.55
240,250,2,963,974,11,7.3,10.17,14.17
240,251,0,494,503,9,3.38,7.72,12.69
240,252,0,555,562,7,2.73,7.98,14.24
240,252,1,775,797,22,2.47,7.77,14.27
240,252,2,953,960,7,1.32,6.94,12.6
240,253,0,778,784,6,10.15,11.77,14.43
240,253,1,956,964,8,3.04,8.09,14.06
240,254,0,709,717,8,5.12,9.34,14.76
241,240,0,477,516,39,1.66,7.4,14.63
241,240,1,598,606,8,3.78,8.5,14.61
241,240,2,847,859,12,12.22,13.15,14.6
241,242,0,737,763,26,7.23,11.33,14.64
241,243,0,785,794,9,11.56,12.91,14.94
241,243,1,1052,1061,9,6.19,9.6,13.97
241,245,0,456,466,10,2.4,8.01,14.58
241,246,0,992,999,7,8.21,10.55,13.9
241,247,0,526,532,6,10.51,12.34,14.99
241,247,1,644,646,2,13.72,13.99,14.12
241,247,2,760,771,11,2.88,8.16,14.16
241,248,0,544,545,1,14.81,14.82,14.83
241,249,0,782,793,11,0.7,7.6,14.51
241,250,0,565,583,18,1.85,8.94,14.89
241,250,1,722,727,5,13.87,14.28,14.84
241,251,0,494,504,10,6.44,9.9,14.66
241,252,0,876,885,9,2.95,8.43,14.45
241,252,1,1058,1066,8,4.72,8.88,13.75
241,253,0,472,487,15,9.12,11.36,14.82
241,253,1,649,666,17,4.33,8.45,13.73
241,253,2,825,844,19,1.61,7.9,14.8
241,253,3,1004,1021,17,6.35,9.79,14.9
241,254,0,885,894,9,7.94,10.79,14.8
241,254,1,994,1003,9,6.89,9.67,13.3
242,193,0,838,849,11,1.84,7.84,14.2
242,193,1,949,962,13,13.25,14.12,14.97
242,240,0,538,543,5,13.47,14.02,14.85
242,241,0,737,751,14,11.37,12.33,14.64
242,241,1,754,763,9,7.23,9.64,13.86
242,245,0,616,626,10,1.92,8.24,14.94
242,246,0,532,549,17,2.82,8.11,14.54
242,247,0,506,512,6,3.28,7.85,12.47
242,247,1,634,648,14,1.31,7.86,14.58
242,247,2,771,778,7,12.5,13.35,14.8
242,248,0,520,527,7,1.93,7.68,13.52
242,249,0,549,557,8,1.95,8.25,14.25
242,250,0,534,543,9,1.86,8,14.78
242,250,1,730,734,4,13.06,13.68,14.33
242,251,0,485,491,6,10.14,11.9,14.15
242,251,1,705,715,10,13.73,14.16,14.9
242,253,0,617,628,11,6.7,9.88,14.47
242,253,1,688,699,11,1.54,7.74,14.31
243,240,0,1003,1010,7,9.64,11.55,14.43
243,240,1,1017,1033,16,2.29,8.21,14.79
243,241,0,785,794,9,11.56,12.91,14.94
243,241,1,1052,1061,9,6.19,9.6,13.97
243,244,0,598,611,13,9.16,11.26,14.62
243,246,0,568,577,9,1.99,8.11,14.52
243,246,1,738,752,14,9.38,11.66,14.99
243,246,2,1076,1076,0,14.84,14.84,14.84
243,247,0,663,670,7,5.25,8.96,13.76
243,248,0,593,604,11,1.66,7.19,12.95
243,248,1,970,978,8,3.34,8.52,14.19
243,249,0,763,773,10,8.84,11.04,14.36
243,249,1,776,809,33,11.96,12.98,14.75
243,249,2,820,831,11,6.44,9.61,13.87
243,249,3,947,951,4,14.12,14.45,14.96
243,250,0,853,865,12,1.3,7.72,14.01
243,251,0,541,551,10,2.03,7.63,13.25
243,251,1,756,766,10,0.54,7.5,14.06
243,252,0,729,738,9,10.76,12.28,14.88
243,252,1,1036,1054,18,4.76,8.62,13.9
243,253,0,466,504,38,7.93,10.01,14.88
243,253,1,545,548,3,14.49,14.65,14.87
243,254,0,682,691,9,7.05,9.94,13.94
243,254,1,936,942,6,12.7,13.51,14.99
243,254,2,1071,1076,5,11.03,12.42,14.23
244,5,0,901,909,8,0.83,8.04,14.66
244,176,0,887,892,5,12.23,13.07,14.26
244,240,0,452,460,8,3.15,7.37,13.72
244,240,1,626,633,7,12.83,13.6,14.98
244,240,2,769,774,5,11.61,12.85,14.48
244,243,0,598,611,13,9.16,11.26,14.62
244,245,0,778,800,22,1.01,7.65,14.62
244,246,0,662,663,1,14.29,14.35,14.42
244,246,1,934,956,22,2.99,8.42,13.56
244,248,0,599,606,7,2.65,8.12,14.44
244,249,0,533,540,7,9.39,11.45,14.86
244,249,1,646,654,8,11.32,12.61,14.9
244,250,0,614,619,5,12.1,13.11,14.65
244,250,1,723,747,24,1.01,7.59,14.92
244,250,2,934,963,29,3.43,8.5,13.79
244,251,0,641,649,8,1.61,7.63,14.94
244,251,1,810,818,8,3.47,8.37,14.55
244,252,0,990,1007,17,7.15,9.81,14.55
244,253,0,810,819,9,5.97,10.21,14.88
245,93,0,1035,1040,5,13.29,13.76,14.66
245,240,0,470,471,1,14.93,14.96,14.98
245,240,1,565,577,12,5.28,8.91,13.74
245,240,2,754,766,12,6.63,9.84,14.29
245,241,0,466,466,0,14.58,14.58,14.58
245,242,0,616,626,10,1.92,8.24,14.94
245,244,0,778,800,22,1.01,7.68,14.62
245,246,0,726,732,6,11.83,13.17,14.86
245,247,0,716,719,3,13.91,14.3,14.9
245,247,1,814,822,8,5.84,9.62,14.13
245,248,0,497,510,13,5.33,9.56,14.99
245,248,1,624,637,13,2.39,8.04,14.46
245,248,2,642,664,22,3.7,8.48,14.46
245,248,3,755,764,9,10.05,11.7,14.25
245,249,0,835,845,10,2.05,7.99,14.21
245,253,0,618,629,11,0.54,7.37,14.21
245,300,0,977,979,2,13.96,14.24,14.5
245,303,0,955,955,0,12.93,12.93,12.93
245,303,1,1004,1012,8,4.11,8.83,14.87
245,304,0,981,989,8,7.51,10.44,14.35
245,343,0,972,978,6,2.34,7.44,12.55
246,240,0,540,546,6,9.32,11.28,13.6
246,240,1,901,914,13,8.43,10.66,13.91
246,240,2,956,963,7,7.99,10.68,14.31
246,241,0,992,999,7,8.21,10.55,13.9
246,242,0,532,549,17,2.82,8.11,14.54
246,243,0,568,577,9,1.99,8.11,14.52
246,243,1,738,752,14,9.38,11.66,14.99
246,244,0,662,663,1,14.29,14.35,14.42
246,244,1,934,956,22,2.99,8.67,14
246,245,0,726,732,6,11.83,13.17,14.86
246,247,0,1015,1023,8,6.51,10.19,14.85
246,247,1,1056,1067,11,11.3,12.74,14.96
246,248,0,466,475,9,4.01,7.88,14.25
246,250,0,535,545,10,1.45,7.64,14.97
246,250,1,932,956,24,1.71,8.76,14.77
246,251,0,577,582,5,11.2,12.29,13.69
246,251,1,873,902,29,5.31,9.25,14.89
246,252,0,501,512,11,2.54,7.71,13.47
246,252,1,621,629,8,1.53,7.56,14.82
246,252,2,739,744,5,11.4,12.6,14.14
246,252,3,863,870,7,11.55,12.72,14.47
246,252,4,956,966,10,7.03,10.37,14.69
246,253,0,700,709,9,4.32,8.98,14.67
246,253,1,955,988,33,1.55,7.86,14.94
246,254,0,551,557,6,13.02,13.58,14.36
246,254,1,867,878,11,3.41,8.37,14.62
246,254,2,992,1000,8,12.3,13.26,14.69
246,254,3,1067,1075,8,3.82,8.58,14.74
247,240,0,525,526,1,14.69,14.81,14.93
247,240,1,807,816,9,11.07,12.54,14.84
247,240,2,879,883,4,11.74,12.63,13.53
247,241,0,526,532,6,10.51,12.34,14.99
247,241,1,644,646,2,13.72,13.99,14.12
247,241,2,760,771,11,2.88,8.16,14.16
247,242,0,506,512,6,3.28,7.85,12.47
247,242,1,634,648,14,1.31,7.86,14.58
247,242,2,771,778,7,12.5,13.35,14.8
247,243,0,663,670,7,5.25,8.96,13.76
247,245,0,716,719,3,13.91,14.3,14.9
247,245,1,814,822,8,5.84,9.62,14.13
247,246,0,1015,1023,8,6.51,10.19,14.85
247,248,0,931,939,8,8.51,11.17,14.76
247,248,1,1027,1033,6,5.61,9.21,13.82
247,251,0,569,577,8,1.46,7.36,13.36
247,251,1,726,735,9,13.67,14.2,15
247,251,2,835,850,15,2.75,10.02,14.7
247,251,3,931,939,8,4.03,8.77,13.93
247,252,0,483,492,9,5.62,9.4,14.78
247,252,1,831,864,33,4.37,8.69,14.91
247,254,0,971,986,15,1.72,7.94,14.86
248,240,0,758,765,7,3.79,8.86,14.94
248,241,0,544,545,1,14.81,14.82,14.83
248,242,0,520,527,7,1.93,7.68,13.52
248,243,0,593,604,11,1.66,7.19,12.95
248,243,1,970,978,8,3.34,8.52,14.19
248,244,0,599,606,7,2.65,8.12,14.44
248,245,0,497,510,13,5.33,9.56,14.99
248,245,1,624,637,13,2.39,8.04,14.46
248,245,2,642,663,21,3.7,8.21,14.36
248,245,3,755,764,9,10.05,11.7,14.25
248,246,0,467,475,8,4.01,7.68,14.25
248,247,0,931,939,8,8.51,11.17,14.76
248,247,1,1027,1033,6,5.61,9.21,13.82
248,249,0,580,584,4,10.36,11.54,12.73
248,249,1,849,853,4,11.99,13.03,14.69
248,250,0,1008,1010,2,14.73,14.82,14.9
248,251,0,829,831,2,14.2,14.42,14.66
248,251,1,934,944,10,1.06,8.02,14.84
248,251,2,977,990,13,6.66,9.86,14.49
248,252,0,585,591,6,9.42,11.32,13.97
248,252,1,669,675,6,1.72,6.81,12.14
248,253,0,626,628,2,14.72,14.8,14.94
248,253,1,922,929,7,7.07,10.06,13.54
248,253,2,1021,1024,3,13.9,14.22,14.61
249,240,0,634,640,6,8.11,10.54,13.8
249,241,0,782,793,11,0.7,7.6,14.51
249,242,0,549,557,8,1.95,8.25,14.25
249,243,0,763,773,10,8.84,11.04,14.36
249,243,1,776,809,33,11.96,12.98,14.75
249,243,2,820,831,11,6.44,9.61,13.87
249,243,3,947,951,4,14.12,14.45,14.96
249,244,0,533,540,7,9.39,11.45,14.86
249,244,1,646,654,8,11.32,12.61,14.9
249,245,0,835,845,10,2.05,7.99,14.21
249,248,0,580,584,4,10.36,11.54,12.73
249,248,1,849,853,4,11.99,13.03,14.69
249,250,0,983,990,7,9.94,11.5,13.57
249,251,0,638,645,7,10.09,11.63,13.68
249,251,1,869,875,6,12.02,13.1,14.45
249,252,0,570,574,4,14.22,14.45,14.77
249,252,1,714,724,10,13.35,13.86,14.6
249,253,0,673,681,8,5.85,9.4,13.86
250,240,0,540,551,11,4.09,8.34,13.67
250,240,1,789,793,4,13.86,14.2,14.55
250,240,2,963,974,11,7.3,10.17,14.17
250,241,0,565,583,18,1.85,8.98,14.89
250,241,1,722,727,5,13.87,14.28,14.84
250,242,0,534,543,9,1.86,8,14.78
250,242,1,730,734,4,13.06,13.68,14.33
250,243,0,853,865,12,1.3,7.72,14.01
250,244,0,614,619,5,12.1,13.11,14.65
250,244,1,723,747,24,1.01,7.59,14.92
250,244,2,934,963,29,3.43,8.67,13.79
250,246,0,535,545,10,1.45,7.64,14.97
250,246,1,932,956,24,1.71,8.84,14.77
250,248,0,1008,1010,2,14.73,14.82,14.9
250,249,0,983,990,7,9.94,11.5,13.57
250,251,0,616,623,7,10.66,12.11,14.47
250,252,0,787,807,20,5.73,9.4,14.02
250,254,0,620,631,11,6.9,9.72,13.5
250,254,1,809,815,6,13.91,14.34,14.97
251,240,0,494,503,9,3.38,7.72,12.69
251,241,0,494,504,10,6.44,9.9,14.66
251,242,0,485,491,6,10.14,11.9,14.15
251,242,1,705,715,10,13.73,14.16,14.9
251,243,0,541,551,10,2.03,7.63,13.25
251,243,1,756,766,10,0.54,7.5,14.06
251,244,0,641,649,8,1.61,7.63,14.94
251,244,1,810,818,8,3.47,8.37,14.55
251,246,0,577,582,5,11.2,12.29,13.69
251,246,1,873,902,29,5.31,9.25,14.89
251,247,0,569,577,8,1.46,7.36,13.36
251,247,1,726,735,9,13.67,14.2,15
251,247,2,835,850,15,2.75,10.18,14.7
251,247,3,931,939,8,4.03,8.77,13.93
251,248,0,829,831,2,14.2,14.42,14.66
251,248,1,934,944,10,1.06,8.02,14.84
251,248,2,977,990,13,6.66,9.86,14.49
251,249,0,638,645,7,10.09,11.63,13.68
251,249,1,869,875,6,12.02,13.1,14.45
251,250,0,616,623,7,10.66,12.11,14.47
251,252,0,595,604,9,4.66,8.81,14.4
251,252,1,841,860,19,7.23,10.55,14.27
251,253,0,523,548,25,4.11,8.8,14.85
251,253,1,805,816,11,6.73,10.2,14.94
251,254,0,611,627,16,5.43,9.08,14.1
251,254,1,854,871,17,0.7,7.17,13.65
252,240,0,555,562,7,2.73,7.98,14.24
252,240,1,775,798,23,2.47,7.82,14.71
252,240,2,953,960,7,1.32,6.94,12.6
252,241,0,876,885,9,2.95,8.43,14.45
252,243,0,729,738,9,10.76,12.28,14.88
252,243,1,1036,1036,0,13.35,13.35,13.35
252,244,0,990,1007,17,7.15,9.72,14.55
252,246,0,501,512,11,2.54,7.71,13.47
252,246,1,621,629,8,1.53,7.56,14.82
252,246,2,739,744,5,11.4,12.6,14.14
252,246,3,863,870,7,11.55,12.72,14.47
252,246,4,956,966,10,7.03,10.37,14.69
252,247,0,483,492,9,5.62,9.4,14.78
252,247,1,831,864,33,4.37,8.77,14.91
252,248,0,585,591,6,9.42,11.32,13.97
252,248,1,669,676,7,1.72,7.74,14.21
252,249,0,570,574,4,14.22,14.45,14.77
252,249,1,714,724,10,13.35,13.86,14.6
252,250,0,787,807,20,5.73,9.4,14.02
252,251,0,595,604,9,4.66,8.81,14.4
252,251,1,841,860,19,7.23,10.5,14.27
252,253,0,950,962,12,10.49,12.13,14.69
252,254,0,816,836,20,9.2,11.37,14.85
252,254,1,839,854,15,14.2,14.47,14.96
253,240,0,778,784,6,10.15,11.77,14.43
253,240,1,956,964,8,3.04,8.09,14.06
253,241,0,472,487,15,9.12,11.36,14.82
253,241,1,649,666,17,4.33,8.45,13.73
253,241,2,825,844,19,1.61,7.9,14.8
253,241,3,1004,1021,17,6.35,9.79,14.9
253,242,0,617,628,11,6.7,9.88,14.47
253,242,1,688,699,11,1.54,7.74,14.31
253,243,0,461,504,43,7.93,10.23,14.88
253,243,1,545,548,3,14.49,14.65,14.87
253,244,0,810,819,9,5.97,10.21,14.88
253,245,0,618,629,11,0.54,7.37,14.21
253,246,0,700,709,9,4.32,8.98,14.67
253,246,1,955,988,33,1.55,7.86,14.94
253,248,0,626,628,2,14.72,14.8,14.94
253,248,1,922,929,7,7.07,9.72,13.54
253,248,2,1021,1024,3,13.9,14.22,14.61
253,249,0,673,681,8,5.85,9.4,13.86
253,250,0,1039,1052,13,4.05,7.66,14.29
253,251,0,523,548,25,4.11,8.8,14.85
253,251,1,805,816,11,6.73,10.2,14.94
253,252,0,950,962,12,10.49,12.13,14.69
253,254,0,999,1005,6,11.34,12.49,14.24
254,240,0,709,717,8,5.12,9.34,14.76
254,241,0,885,894,9,7.94,10.79,14.8
254,241,1,994,1003,9,6.89,9.67,13.3
254,243,0,682,691,9,7.05,9.94,13.94
254,243,1,936,942,6,12.7,13.51,14.99
254,246,0,551,557,6,13.02,13.58,14.36
254,246,1,867,878,11,3.41,8.37,14.62
254,246,2,992,1000,8,12.3,13.26,14.69
254,247,0,971,986,15,1.72,7.94,14.86
254,250,0,620,631,11,6.9,9.72,13.5
254,250,1,809,815,6,13.91,14.34,14.97
254,251,0,611,627,16,5.43,9.08,14.1
254,251,1,854,871,17,0.7,7.17,13.65
254,252,0,816,836,20,9.2,11.37,14.85
254,252,1,839,854,15,14.2,14.47,14.96
254,253,0,999,1005,6,11.34,12.49,14.24
255,257,0,632,646,14,13.02,13.65,14.73
255,257,1,689,698,9,3.33,8.48,14.26
255,257,2,1014,1023,9,7.97,10.65,14.21
255,258,0,518,519,1,14.55,14.57,14.58
255,258,1,725,735,10,2.35,7.69,14.38
255,258,2,750,778,28,10.22,11.94,14.76
255,258,3,935,944,9,3.53,8.37,14.55
255,259,0,484,512,28,3.07,8.02,14.11
255,260,0,478,488,10,6.77,9.14,14.05
255,260,1,618,629,11,2.86,8.52,14.79
255,260,2,767,772,5,12.9,13.64,14.77
255,261,0,564,577,13,1.43,8.24,14.44
255,261,1,695,703,8,5.18,8.87,13.26
255,261,2,825,830,5,12.8,13.7,14.83
255,262,0,478,482,4,13.38,13.77,14.08
255,262,1,811,842,31,2.45,7.91,14.46
255,263,0,908,926,18,2.99,8.2,14.85
255,264,0,723,732,9,6.67,10.22,14.97
255,264,1,740,760,20,10.74,12.15,14.41
255,265,0,529,558,29,11.94,12.97,14.72
255,265,1,565,567,2,14.74,14.88,15
255,266,0,478,482,4,11.01,12.83,14.89
255,266,1,703,707,4,14.45,14.6,14.78
255,266,2,721,724,3,14.35,14.58,14.88
255,267,0,508,528,20,5.04,9.18,14.83
255,267,1,655,661,6,13.76,14.17,14.75
255,268,0,687,694,7,12.65,13.4,14.52
256,255,0,456,473,17,0.97,7.62,14.73
256,257,0,580,587,7,1.39,6.94,12.56
256,258,0,530,537,7,6.13,9.54,13.97
256,258,1,858,866,8,4.17,9.09,14.43
256,258,2,941,947,6,8.41,10.66,13.84
256,259,0,534,553,19,7.54,10.24,14.23
256,259,1,585,598,13,2.02,7.93,14.57
256,260,0,448,461,13,9.4,11.43,14.72
256,260,1,710,716,6,11.04,12.43,14.21
256,260,2,917,926,9,4.01,8.68,14.82
256,261,0,587,602,15,4.45,8.8,14.89
256,261,1,610,615,5,14.14,14.43,14.94
256,261,2,957,965,8,4.09,8.62,14.21
256,262,0,465,468,3,14.55,14.67,14.83
256,262,1,498,507,9,1.61,7.95,14.35
256,264,0,606,614,8,1.94,8.2,14.23
256,264,1,861,868,7,5.86,9.52,14.86
256,264,2,1028,1036,8,0.96,7.89,14.61
256,265,0,479,487,8,0.82,7.22,13.56
256,266,0,464,479,15,1.06,8.32,14.91
256,266,1,639,649,10,6.81,9.68,13.44
256,266,2,808,819,11,2.87,7.58,12.93
256,267,0,953,962,9,10.51,12.27,14.92
256,268,0,554,563,9,6.15,9.6,13.94
257,255,0,632,646,14,13.02,13.65,14.73
257,255,1,689,698,9,3.33,8.48,14.26
257,255,2,1014,1023,9,7.97,10.65,14.21
257,256,0,580,587,7,1.39,6.94,12.56
257,258,0,621,629,8,2.4,7.82,14.61
257,259,0,560,580,20,0.9,8.32,14.87
257,259,1,734,745,11,1.51,7.84,14.3
257,259,2,870,880,10,9.03,11.29,14.39
257,260,0,520,520,0,14.73,14.73,14.73
257,261,0,680,687,7,3.93,8.6,14.16
257,261,1,779,785,6,7.67,10.73,14.87
257,263,0,432,433,1,11.74,12.67,13.61
257,263,1,649,657,8,9.34,11.59,14.46
257,264,0,704,710,6,2.29,7.49,12.78
257,265,0,928,936,8,3.32,8.17,14.11
257,265,1,1055,1060,5,10.69,12.25,14.73
257,266,0,698,702,4,11.88,12.78,13.81
257,266,1,957,957,0,8.6,8.6,8.6
257,266,2,968,979,11,4.69,9.09,14.44
257,267,0,648,658,10,2.87,8.05,13.57
257,268,0,671,678,7,10.17,11.71,14.05
257,268,1,683,695,12,5.14,9.1,14.13
257,269,0,843,861,18,3.45,9.75,14.47
258,255,0,518,519,1,14.55,14.57,14.58
258,255,1,724,735,11,2.35,8.16,14.76
258,255,2,750,778,28,10.22,11.94,14.76
258,255,3,935,944,9,3.53,8.37,14.55
258,256,0,530,537,7,6.13,9.54,13.97
258,256,1,858,866,8,4.17,9.09,14.43
258,256,2,941,947,6,8.41,10.66,13.84
258,257,0,621,629,8,2.4,7.82,14.61
258,259,0,521,534,13,0.52,7.63,14.9
258,259,1,782,788,6,12.94,13.78,14.87
258,259,2,1038,1050,12,9.2,11.31,14.94
258,260,0,628,641,13,2.36,7.99,14.3
258,260,1,763,770,7,4.75,8.46,13.09
258,260,2,866,874,8,9.78,11.89,14.61
258,260,3,1029,1041,12,5.17,9.06,14.33
258,261,0,811,818,7,3.29,8.22,13.87
258,262,0,639,645,6,9.75,11.95,14.54
258,263,0,467,480,13,0.42,7.56,14.96
258,263,1,517,529,12,0.97,7.74,14.62
258,263,2,992,1005,13,0.37,7.56,14.98
258,264,0,723,778,55,4.99,8.43,14.86
258,264,1,861,874,13,6.02,9.61,14.95
258,265,0,523,527,4,12.47,13.32,14.9
258,265,1,608,616,8,3.04,8.05,13.83
258,266,0,718,727,9,8.87,11.22,13.84
258,267,0,515,521,6,12.63,13.4,14.63
258,268,0,441,455,14,2.11,7.45,14.79
258,268,1,503,513,10,0.97,7.41,13.94
258,268,2,606,613,7,9.97,11.57,13.83
258,268,3,707,716,9,2.64,8.34,14.83
259,255,0,484,512,28,3.07,8.02,14.11
259,256,0,534,553,19,7.54,10.24,14.23
259,256,1,585,598,13,2.02,7.93,14.57
259,257,0,560,580,20,0.9,8.32,14.87
259,257,1,734,745,11,1.51,7.84,14.3
259,257,2,870,880,10,9.03,11.29,14.39
259,258,0,521,534,13,0.52,7.63,14.9
259,258,1,782,788,6,12.94,13.78,14.87
259,260,0,657,669,12,4.3,8.63,14.34
259,261,0,590,600,10,3.73,8.26,13.48
259,262,0,451,479,28,11.26,12.32,14.83
259,263,0,519,531,12,9.21,11.35,14.44
259,264,0,637,658,21,2.3,8.41,14.99
259,264,1,776,786,10,0.56,7.11,13.26
259,265,0,509,527,18,9.25,11.45,14.85
259,266,0,442,461,19,3.37,8.32,14.54
259,267,0,512,518,6,13.99,14.36,14.91
259,267,1,881,897,16,6.84,10.15,14.86
259,268,0,760,764,4,14.31,14.56,14.98
259,269,0,775,810,35,9.27,11.35,14.75
260,255,0,470,488,18,6.77,9.95,14.55
260,255,1,618,629,11,2.86,8.52,14.79
260,255,2,767,772,5,12.9,13.64,14.77
260,256,0,710,716,6,11.04,12.43,14.21
260,256,1,917,926,9,4.01,8.68,14.82
260,257,0,520,520,0,14.73,14.73,14.73
260,258,0,628,641,13,2.36,7.99,14.3
260,258,1,763,770,7,4.75,8.46,13.09
260,258,2,866,874,8,9.78,11.89,14.61
260,258,3,1029,1041,12,5.17,9.06,14.33
260,259,0,657,669,12,4.3,8.63,14.34
260,261,0,1009,1011,2,14.2,14.5,14.75
260,262,0,483,490,7,10.81,12.35,14.56
260,262,1,642,654,12,5.88,9.63,14.46
260,262,2,767,779,12,4.46,8.73,13.85
260,262,3,892,898,6,8.56,10.84,13.73
260,263,0,598,602,4,12.72,13.35,14.2
260,264,0,546,553,7,0.96,7.18,13.41
260,264,1,654,661,7,0.95,7.25,13.72
260,264,2,761,768,7,1.79,7.25,12.77
260,264,3,868,876,8,1.16,8.19,14.6
260,264,4,976,983,7,1.45,7.37,13.65
260,265,0,491,499,8,9.43,11.54,14.35
260,266,0,482,497,15,12.74,13.52,14.9
260,266,1,563,572,9,2.88,8.49,14.58
260,267,0,595,604,9,6.88,9.99,14.14
260,267,1,824,835,11,4.52,8.96,14.44
260,268,0,877,885,8,8.06,10.79,14.71
260,268,1,1009,1017,8,8.51,11.15,14.59
260,269,0,834,845,11,2.17,7.7,13.91
260,269,1,969,973,4,13.82,14.22,14.92
261,255,0,564,577,13,1.43,8.41,14.44
261,255,1,695,703,8,5.18,8.87,13.26
261,255,2,825,830,5,12.8,13.7,14.83
261,256,0,587,602,15,4.45,8.8,14.89
261,256,1,610,615,5,14.14,14.43,14.94
261,256,2,957,965,8,4.09,8.62,14.21
261,257,0,680,688,8,3.93,9.07,14.27
261,257,1,779,785,6,7.67,10.73,14.87
261,258,0,811,818,7,3.29,8.22,13.87
261,259,0,590,600,10,3.73,8.26,13.48
261,260,0,1009,1011,2,14.2,14.5,14.75
261,263,0,655,664,9,5.24,9.45,14.68
261,263,1,873,881,8,12.89,13.53,14.48
261,263,2,1031,1039,8,8.55,11.31,14.76
261,264,0,512,518,6,10.33,12.19,14.41
261,264,1,610,617,7,2.04,8.23,14.91
261,264,2,710,712,2,14.27,14.63,14.94
261,265,0,573,581,8,11.88,12.98,14.61
261,265,1,870,874,4,12.6,13.26,13.97
261,265,2,977,982,5,10.43,11.76,13.55
261,266,0,700,706,6,5.54,8.69,12.27
261,266,1,1043,1048,5,6.3,9.37,15
261,267,0,657,664,7,8.12,10.18,12.84
261,267,1,962,965,3,13.95,14.34,14.92
261,268,0,673,686,13,1.98,8.26,14.98
261,268,1,796,807,11,4.41,8.85,14.67
261,268,2,906,914,8,9.03,10.98,13.61
261,269,0,642,652,10,0.73,7.48,13.75
261,269,1,891,898,7,11.11,12.65,14.77
262,255,0,480,482,2,13.38,13.6,14.02
262,255,1,811,842,31,2.45,7.91,14.46
262,255,2,1061,1061,0,11.83,11.83,11.83
262,256,0,498,507,9,1.61,7.95,14.35
262,257,0,1062,1062,0,12.35,12.35,12.35
262,258,0,639,645,6,9.75,11.95,14.54
262,260,0,483,490,7,10.81,12.35,14.56
262,260,1,642,654,12,5.88,9.63,14.46
262,260,2,767,779,12,4.46,8.73,13.85
262,260,3,892,898,6,8.56,10.84,13.73
262,263,0,910,914,4,13.25,13.94,14.92
262,265,0,487,494,7,5.9,8.99,12.73
262,265,1,790,797,7,6.14,9.17,12.82
262,265,2,1062,1062,0,9.81,9.81,9.81
262,266,0,480,488,8,1.3,7.5,14.24
262,266,1,747,754,7,6.95,9.96,13.86
262,267,0,712,721,9,6.92,9.87,13.66
262,267,1,931,939,8,5.76,9.07,13.28
263,255,0,908,926,18,2.99,8.2,14.85
263,257,0,649,657,8,9.34,11.59,14.46
263,258,0,467,480,13,0.42,7.56,14.96
263,258,1,517,529,12,0.97,7.74,14.62
263,258,2,992,1005,13,0.37,7.56,14.98
263,259,0,519,531,12,9.21,11.35,14.44
263,260,0,598,602,4,12.72,13.35,14.2
263,261,0,655,664,9,5.24,9.45,14.68
263,261,1,873,881,8,12.89,13.53,14.48
263,261,2,1031,1039,8,8.55,11.31,14.76
263,262,0,910,914,4,13.25,13.94,14.92
263,264,0,455,463,8,1.74,7.45,13.8
263,264,1,1001,1009,8,5.43,9.38,14.54
263,265,0,523,535,12,5.01,8.92,14.14
263,265,1,663,674,11,1.95,7.95,14.57
263,266,0,671,680,9,1.47,7.71,14.63
263,266,1,764,773,9,0.82,7.52,14.23
263,267,0,500,510,10,5.96,9.17,13.18
263,267,1,537,667,130,5.95,9.51,14.85
263,267,2,736,742,6,12.43,13.33,14.84
263,268,0,487,498,11,12.3,13.27,14.79
263,268,1,649,651,2,14.51,14.62,14.7
263,269,0,1003,1018,15,0.47,7.64,14.97
264,255,0,723,732,9,6.67,10.29,14.97
264,255,1,740,760,20,10.74,12.15,14.41
264,256,0,606,614,8,1.94,8.2,14.23
264,256,1,861,868,7,5.86,9.52,14.86
264,256,2,1028,1036,8,0.96,7.89,14.61
264,257,0,704,710,6,2.29,7.49,12.78
264,258,0,723,778,55,4.99,8.35,14.86
264,258,1,861,874,13,6.02,9.61,14.95
264,259,0,637,658,21,2.3,8.42,14.99
264,259,1,776,786,10,0.56,7.11,13.26
264,260,0,546,553,7,0.96,7.18,13.41
264,260,1,654,661,7,0.95,7.25,13.72
264,260,2,761,768,7,1.79,7.25,12.77
264,260,3,868,876,8,1.16,8.19,14.6
264,260,4,976,983,7,1.45,7.37,13.65
264,261,0,512,518,6,10.33,12.35,14.41
264,261,1,610,617,7,2.04,8.23,14.91
264,261,2,710,712,2,14.27,14.63,14.94
264,263,0,455,463,8,1.74,7.45,13.8
264,263,1,1001,1009,8,5.43,9.38,14.54
264,265,0,690,698,8,0.54,7.2,13.3
264,266,0,534,542,8,1.96,7.77,14.18
264,266,1,720,728,8,4.57,9.05,14.78
264,267,0,443,448,5,13.79,14.19,14.8
264,267,1,1034,1046,12,6.73,9.77,14.01
264,268,0,809,820,11,1.54,7.97,14.72
264,268,1,827,857,30,0.45,10.71,14.8
264,269,0,458,462,4,13.37,14.01,14.58
264,269,1,571,580,9,5.51,9.47,14.55
264,269,2,676,686,10,1.17,8.03,14.95
264,269,3,781,790,9,1.26,7.41,13.87
264,269,4,987,1008,21,0.62,7.74,14.63
265,255,0,433,451,18,0.2,7.43,14.21
265,255,1,529,558,29,11.94,12.97,14.72
265,255,2,565,567,2,14.74,14.88,15
265,256,0,479,487,8,0.82,7.22,13.56
265,257,0,928,936,8,3.32,8.17,14.11
265,258,0,523,527,4,12.47,13.32,14.9
265,258,1,608,616,8,3.04,8.05,13.83
265,259,0,509,527,18,9.25,11.45,14.85
265,260,0,423,439,16,3.46,7.84,14.15
265,260,1,491,499,8,9.43,11.54,14.35
265,261,0,573,581,8,11.88,12.98,14.61
265,261,1,870,874,4,12.6,13.26,13.97
265,261,2,977,982,5,10.43,11.76,13.55
265,262,0,439,445,6,14.11,14.45,14.97
265,262,1,487,494,7,5.9,8.99,12.73
265,262,2,790,797,7,6.14,9.17,12.82
265,263,0,523,535,12,5.01,8.92,14.14
265,263,1,663,674,11,1.95,7.95,14.57
265,264,0,690,698,8,0.54,7.2,13.3
265,267,0,519,530,11,8.91,11.01,14.05
265,267,1,669,681,12,3.41,8.6,14.81
265,268,0,595,627,32,9.16,11.22,14.57
265,269,0,627,637,10,3.61,8.26,13.82
265,269,1,948,957,9,7.32,10.12,13.8
266,18,0,856,867,11,7.49,10.96,14.5
266,19,0,855,855,0,11.94,11.94,11.94
266,28,0,855,855,0,7.2,7.2,7.2
266,28,1,876,900,24,1.3,7.89,14.95
266,255,0,462,482,20,9.11,11.46,14.89
266,255,1,703,707,4,14.45,14.6,14.78
266,255,2,721,724,3,14.35,14.58,14.88
266,256,0,464,479,15,1.06,8.49,14.91
266,256,1,639,649,10,6.81,9.68,13.44
266,256,2,808,819,11,2.87,7.58,12.93
266,257,0,698,702,4,11.88,12.78,13.81
266,257,1,957,957,0,8.6,8.6,8.6
266,257,2,968,979,11,4.69,9.09,14.44
266,258,0,426,436,10,9.05,10.63,13.96
266,258,1,718,727,9,8.87,11.2,13.84
266,259,0,442,461,19,3.37,8.32,14.54
266,260,0,482,497,15,12.74,13.52,14.9
266,260,1,563,572,9,2.88,8.49,14.58
266,261,0,428,443,15,6.3,9.71,14.69
266,261,1,700,706,6,5.54,8.69,12.27
266,261,2,1043,1051,8,6.3,10.15,15
266,262,0,453,468,15,4.75,8.64,13.68
266,262,1,480,488,8,1.3,7.5,14.24
266,262,2,747,754,7,6.95,9.96,13.86
266,263,0,671,680,9,1.47,7.71,14.63
266,263,1,764,773,9,0.82,7.52,14.23
266,264,0,534,542,8,1.96,7.77,14.18
266,264,1,720,728,8,4.57,9.05,14.78
266,267,0,677,683,6,11.38,12.63,14.67
266,267,1,775,781,6,11.58,12.81,14.9
266,268,0,1053,1062,9,5.1,9.12,13.73
266,333,0,865,865,0,14.53,14.53,14.53
267,255,0,508,528,20,5.04,9.18,14.83
267,255,1,655,661,6,13.76,14.17,14.75
267,256,0,953,962,9,10.51,12.27,14.92
267,257,0,648,658,10,2.87,8.05,13.57
267,258,0,515,521,6,12.63,13.4,14.63
267,259,0,512,518,6,13.99,14.36,14.91
267,259,1,881,897,16,6.84,10.15,14.86
267,260,0,595,604,9,6.88,9.99,14.14
267,260,1,824,835,11,4.52,8.96,14.44
267,261,0,657,664,7,8.12,10.18,12.84
267,261,1,962,965,3,13.95,14.34,14.92
267,262,0,712,721,9,6.92,9.87,13.66
267,262,1,931,939,8,5.76,9.07,13.28
267,263,0,500,510,10,5.96,9.17,13.18
267,263,1,537,667,130,5.95,9.51,14.85
267,263,2,736,742,6,12.43,13.33,14.84
267,265,0,519,530,11,8.91,11.01,14.05
267,265,1,669,681,12,3.41,8.6,14.81
267,266,0,677,683,6,11.38,12.63,14.67
267,266,1,775,781,6,11.58,12.81,14.9
268,255,0,687,694,7,12.65,13.4,14.52
268,256,0,554,563,9,6.15,9.6,13.94
268,257,0,671,678,7,10.17,11.71,14.05
268,257,1,683,695,12,5.14,9.1,14.13
268,258,0,503,513,10,0.97,7.41,13.94
268,258,1,606,613,7,9.97,11.57,13.83
268,258,2,707,716,9,2.64,8.34,14.83
268,259,0,760,764,4,14.31,14.56,14.98
268,260,0,877,885,8,8.06,10.79,14.71
268,260,1,1009,1017,8,8.51,11.15,14.59
268,261,0,673,686,13,1.98,8.26,14.98
268,261,1,796,807,11,4.41,8.98,14.67
268,261,2,906,914,8,9.03,10.98,13.61
268,263,0,487,498,11,12.3,13.27,14.79
268,263,1,649,651,2,14.51,14.62,14.7
268,264,0,809,820,11,1.54,7.97,14.72
268,264,1,827,857,30,0.45,10.62,14.8
268,265,0,595,627,32,9.16,11.22,14.57
268,266,0,1053,1058,5,5.1,7.89,12.89
268,269,0,630,634,4,14,14.34,14.76
268,269,1,763,775,12,3.79,8.48,14.28
269,257,0,843,861,18,3.45,9.69,14.47
269,259,0,775,810,35,9.27,11.35,14.75
269,260,0,834,845,11,2.17,7.7,13.91
269,260,1,969,973,4,13.82,14.22,14.92
269,261,0,642,652,10,0.73,7.48,13.75
269,261,1,891,898,7,11.11,12.65,14.77
269,263,0,1003,1018,15,0.47,7.64,14.97
269,264,0,461,462,1,13.85,14.13,14.42
269,264,1,571,580,9,5.51,9.47,14.55
269,264,2,676,686,10,1.17,8.03,14.95
269,264,3,781,790,9,1.26,7.41,13.87
269,264,4,987,1008,21,0.62,7.8,14.63
269,265,0,627,637,10,3.61,8.26,13.82
269,265,1,948,957,9,7.32,10.12,13.8
269,268,0,630,634,4,14,14.34,14.76
269,268,1,763,775,12,3.79,8.48,14.28
270,271,0,553,571,18,5.35,9.16,14.49
270,271,1,792,799,7,11.73,12.96,14.72
270,272,0,497,509,12,0.64,7.29,14.07
270,272,1,625,654,29,4.27,10.46,14.92
270,272,2,912,934,22,6.43,9.87,14.94
270,273,0,1006,1013,7,7.78,10.2,13.55
270,274,0,778,784,6,11.49,12.91,15
270,275,0,669,677,8,4.67,8.78,13.57
270,276,0,559,567,8,4.26,8.39,12.97
270,277,0,422,437,15,5.98,9.59,14.9
270,278,0,794,794,0,13.91,13.91,13.91
270,279,0,817,821,4,11.74,12.84,14.21
270,279,1,969,984,15,2.76,7.58,13.88
270,280,0,622,652,30,1.47,7.3,14.88
270,280,1,990,1003,13,5.57,9.17,13.88
270,281,0,458,472,14,11.72,13.11,14.61
270,282,0,516,522,6,12.49,13.32,14.5
270,282,1,771,784,13,9.22,11.36,14.51
270,282,2,878,889,11,2.63,8.44,14.82
270,283,0,870,876,6,9.12,11.09,13.5
270,283,1,1004,1018,14,1.59,7.72,14.98
270,284,0,790,800,10,8.31,10.8,14.1
271,270,0,553,571,18,5.35,9.16,14.49
271,270,1,792,799,7,11.73,12.96,14.72
271,270,2,1043,1078,35,4.88,8.81,14.29
271,272,0,680,682,2,14.88,14.92,14.95
271,273,0,601,613,12,11.78,12.98,14.94
271,273,1,819,825,6,11.61,12.58,13.81
271,274,0,475,489,14,9.64,11.75,14.93
271,275,0,463,475,12,2.57,7.9,14.27
271,275,1,844,854,10,8.64,10.86,13.86
271,276,0,561,571,10,1.87,7.86,14.71
271,276,1,834,840,6,12.32,13.12,14.28
271,277,0,812,826,14,9.18,11.3,14.65
271,278,0,794,794,0,9.38,9.38,9.38
271,279,0,453,459,6,14.75,14.82,14.94
271,279,1,682,692,10,1.05,7.71,14.04
271,279,2,855,879,24,4.34,8.14,14.36
271,281,0,705,720,15,5.97,9.38,14.09
271,282,0,942,955,13,8.22,10.69,14.3
271,282,1,1053,1078,25,5.17,8.38,14.95
271,283,0,617,635,18,12.16,13.09,14.61
271,284,0,784,803,19,7.24,10.19,14.63
272,270,0,497,509,12,0.64,7.29,14.07
272,270,1,625,654,29,4.27,10.32,14.92
272,270,2,912,934,22,6.43,9.87,14.94
272,271,0,680,682,2,14.88,14.92,14.95
272,273,0,683,705,22,4.41,8.95,14.86
272,273,1,986,1000,14,11.5,12.72,14.75
272,274,0,654,664,10,11.65,12.82,14.66
272,275,0,546,559,13,0.96,7.34,13.79
272,276,0,727,739,12,10.89,12.35,14.63
272,276,1,791,795,4,13.31,13.76,14.32
272,276,2,931,943,12,1.09,7.88,14.52
272,278,0,798,832,34,5.46,8.43,14.75
272,279,0,525,536,11,0.9,7.64,14.47
272,279,1,688,702,14,10.33,12.09,14.89
272,279,2,765,776,11,2.22,8.07,14.74
272,279,3,1005,1016,11,3.24,8.52,14.97
272,280,0,614,647,33,0.61,7.61,14.74
272,280,1,1022,1045,23,1.84,7.32,14.72
272,281,0,566,583,17,9.03,11.29,14.91
272,281,1,1017,1045,28,4.46,8.95,14.29
272,282,0,876,878,2,14.71,14.81,14.92
272,283,0,834,854,20,0.94,8.82,14.87
272,284,0,727,734,7,13.42,13.88,14.52
273,270,0,1006,1013,7,7.78,10.2,13.55
273,271,0,601,613,12,11.78,12.98,14.94
273,271,1,819,825,6,11.61,12.58,13.81
273,272,0,683,705,22,4.41,8.95,14.86
273,272,1,986,1000,14,11.5,12.72,14.75
273,274,0,672,675,3,13.78,14.17,14.69
273,274,1,796,808,12,0.93,8.38,14.93
273,274,2,928,932,4,13.32,13.97,14.92
273,276,0,470,494,24,1.2,7.01,14.63
273,276,1,596,603,7,11.31,12.41,14
273,276,2,954,961,7,1.5,7.32,13.18
273,277,0,542,550,8,4.76,8.72,13.89
273,277,1,822,833,11,1.27,7.83,14.7
273,279,0,691,702,11,9.24,11.2,14.05
273,279,1,834,840,6,7.24,10.07,13.89
273,280,0,837,848,11,11.75,12.91,14.77
273,282,0,675,676,1,14.78,14.84,14.9
273,283,0,470,474,4,3.77,8.83,13.9
273,283,1,1008,1014,6,8.27,10.37,12.86
273,284,0,831,864,33,1.49,8.45,14.76
274,270,0,778,784,6,11.49,12.91,15
274,271,0,475,489,14,9.64,11.75,14.93
274,272,0,654,664,10,11.65,12.82,14.66
274,273,0,672,675,3,13.78,14.17,14.69
274,273,1,796,808,12,0.93,8.24,14.93
274,273,2,928,932,4,13.32,13.97,14.92
274,275,0,825,833,8,9.17,11.3,14.04
274,276,0,622,630,8,10.25,12.31,15
274,277,0,531,540,9,8.16,10.77,14.49
274,277,1,760,760,0,12.38,12.38,12.38
274,278,0,536,557,21,1.67,7.81,14.75
274,278,1,862,872,10,9.83,11.71,14.58
274,278,2,1011,1031,20,12.52,13.39,14.91
274,281,0,722,733,11,3.69,8.48,14.37
274,282,0,690,748,58,4.45,10.75,14.64
274,282,1,782,791,9,2.04,7.64,13.71
274,283,0,749,759,10,7.78,10.67,14.51
274,283,1,862,869,7,7.92,10.23,13.29
275,270,0,669,677,8,4.67,8.78,13.57
275,271,0,463,475,12,2.57,7.9,14.27
275,271,1,844,854,10,8.64,10.86,13.86
275,272,0,546,559,13,0.96,7.34,13.79
275,274,0,825,833,8,9.17,11.3,14.04
275,274,1,1046,1061,15,9.04,11.25,14.53
275,276,0,1030,1044,14,8.31,10.77,14.36
275,277,0,566,574,8,5.11,9.59,14.71
275,278,0,1039,1048,9,12.87,13.57,14.69
275,279,0,512,519,7,7.83,10.58,14.2
275,279,1,852,858,6,7.43,9.78,12.49
275,280,0,698,722,24,1.97,7.05,14.38
275,281,0,691,705,14,0.31,7.66,14.59
275,281,1,867,883,16,1.04,7.74,14.97
275,281,2,902,913,11,8.89,11.08,14.53
275,282,0,566,576,10,4.03,8.41,13.51
275,283,0,921,931,10,4.87,9.35,14.87
275,284,0,643,658,15,3.37,8.26,14.51
275,284,1,1028,1039,11,2.24,7.5,13.26
276,270,0,559,567,8,4.26,8.39,12.97
276,271,0,561,571,10,1.87,7.86,14.71
276,271,1,834,840,6,12.32,13.12,14.28
276,272,0,727,739,12,10.89,12.35,14.63
276,272,1,791,795,4,13.31,13.76,14.32
276,272,2,931,943,12,1.09,7.88,14.52
276,273,0,471,494,23,1.2,7.18,14.63
276,273,1,596,603,7,11.31,12.41,14
276,273,2,954,961,7,1.5,7.32,13.18
276,274,0,622,630,8,10.25,12.31,15
276,274,1,1040,1049,9,9.45,10.71,13.56
276,275,0,1030,1044,14,8.31,10.77,14.36
276,277,0,847,854,7,8.98,11.23,14.32
276,278,0,1036,1049,13,5.29,9.15,14.17
276,279,0,640,647,7,11.55,12.84,14.79
276,279,1,753,758,5,8.18,10.31,12.9
276,279,2,842,849,7,7.06,9.67,12.9
276,280,0,877,894,17,5.52,9.41,14.64
276,281,0,656,665,9,4.24,8.8,14.5
276,281,1,688,695,7,13.87,14.23,14.79
276,282,0,813,818,5,8.22,10.08,12.3
276,282,1,989,990,1,14.62,14.76,14.91
276,283,0,471,473,2,7.7,10.15,12.61
276,283,1,578,587,9,4.31,9.5,14.83
276,283,2,687,691,4,10.93,12.02,13.27
276,284,0,1023,1037,14,7.46,10.46,14.73
277,271,0,812,826,14,9.18,11.3,14.65
277,273,0,542,550,8,4.76,8.72,13.89
277,273,1,822,833,11,1.27,7.83,14.7
277,274,0,531,540,9,8.16,10.77,14.49
277,274,1,760,760,0,12.38,12.38,12.38
277,275,0,566,574,8,5.11,9.59,14.71
277,276,0,847,854,7,8.98,11.23,14.32
277,278,0,529,538,9,8.8,10.93,14.03
277,279,0,550,556,6,6.64,10,14.88
277,279,1,782,801,19,7.58,10.48,14.8
277,280,0,592,595,3,11.04,12.24,13.81
277,280,1,854,877,23,6.87,10.08,14.91
277,281,0,857,866,9,6.53,9.83,14.64
277,282,0,563,572,9,0.77,7.74,14.7
277,283,0,761,761,0,10.64,10.64,10.64
277,284,0,761,761,0,3.9,3.9,3.9
277,284,1,830,833,3,13.94,14.3,14.87
277,284,2,881,908,27,9.2,10.73,14.84
278,270,0,794,794,0,13.91,13.91,13.91
278,271,0,794,794,0,9.38,9.38,9.38
278,272,0,798,832,34,5.46,8.43,14.75
278,274,0,536,557,21,1.67,7.81,14.75
278,274,1,862,872,10,9.83,11.71,14.58
278,274,2,1011,1031,20,12.52,13.38,14.91
278,276,0,1036,1036,0,12.91,12.91,12.91
278,277,0,529,538,9,8.8,10.93,14.03
278,279,0,574,595,21,3.23,9.45,14.89
278,279,1,914,927,13,7.02,10.19,14.51
278,280,0,793,793,0,14.61,14.61,14.61
278,282,0,482,492,10,9.02,11.11,13.94
278,282,1,891,904,13,10.02,11.85,14.92
278,283,0,797,797,0,14.58,14.58,14.58
278,284,0,557,581,24,5.7,9.54,14.86
278,284,1,794,794,0,14.54,14.54,14.54
279,270,0,817,821,4,11.74,12.84,14.21
279,270,1,969,984,15,2.76,7.84,13.88
279,271,0,682,692,10,1.05,7.71,14.04
279,271,1,855,879,24,4.34,8.08,14.36
279,272,0,525,536,11,0.9,7.64,14.47
279,272,1,688,702,14,10.33,12.09,14.89
279,272,2,765,776,11,2.22,8.07,14.74
279,272,3,1005,1016,11,3.24,8.52,14.97
279,273,0,691,702,11,9.24,11.2,14.05
279,273,1,834,840,6,7.24,10.07,13.89
279,275,0,512,519,7,7.83,10.58,14.2
279,275,1,852,858,6,7.43,9.78,12.49
279,276,0,640,647,7,11.55,12.84,14.79
279,276,1,753,758,5,8.18,10.31,12.9
279,276,2,842,849,7,7.06,9.67,12.9
279,277,0,550,556,6,6.64,10,14.88
279,277,1,782,801,19,7.58,10.48,14.8
279,278,0,574,595,21,3.23,9.53,14.89
279,278,1,914,927,13,7.02,10.19,14.51
279,280,0,508,513,5,13.1,13.69,14.52
279,280,1,667,675,8,9.48,11.22,13.56
279,281,0,499,512,13,5.31,10.3,14.97
279,281,1,999,1008,9,5.66,9.2,13.6
279,282,0,642,650,8,13.77,14.18,14.93
279,282,1,906,914,8,3.78,9.17,14.87
279,282,2,1027,1034,7,11.92,13.02,14.58
279,283,0,778,785,7,4.55,8.86,14.7
279,283,1,1022,1025,3,14.23,14.48,14.83
279,284,0,597,607,10,2.86,7.94,14.16
279,284,1,839,839,0,14.92,14.92,14.92
279,284,2,959,968,9,0.71,7.7,14.73
280,270,0,622,652,30,1.47,7.2,14.88
280,270,1,990,1003,13,5.57,9.17,13.88
280,272,0,614,647,33,0.61,7.61,14.74
280,272,1,1022,1030,8,8.86,11.75,14.72
280,273,0,837,848,11,11.75,12.91,14.77
280,275,0,698,722,24,1.97,7.11,14.38
280,276,0,877,894,17,5.52,9.41,14.64
280,277,0,592,595,3,11.04,12.24,13.81
280,277,1,854,877,23,6.87,10.08,14.91
280,279,0,508,513,5,13.1,13.69,14.52
280,279,1,667,675,8,9.48,11.22,13.56
280,281,0,495,543,48,6.87,10.91,14.92
280,281,1,695,702,7,13.51,14.05,14.95
280,281,2,861,864,3,14.52,14.61,14.72
280,281,3,953,990,37,9.42,11.39,14.65
280,281,4,1020,1030,10,6.79,9.05,13.75
280,282,0,656,668,12,5.5,9.66,14.81
280,284,0,826,857,31,7.56,10.45,14.93
281,270,0,465,472,7,11.72,12.47,14.15
281,271,0,705,720,15,5.97,9.38,14.09
281,272,0,566,583,17,9.03,11.29,14.91
281,272,1,1017,1033,16,4.46,7.92,14.29
281,274,0,722,733,11,3.69,8.48,14.37
281,275,0,691,705,14,0.31,7.66,14.59
281,275,1,867,883,16,1.04,7.74,14.97
281,275,2,902,913,11,8.89,11.08,14.53
281,276,0,656,665,9,4.24,8.8,14.5
281,276,1,688,695,7,13.87,14.23,14.79
281,277,0,857,866,9,6.53,9.83,14.64
281,279,0,499,512,13,5.31,10.14,14.97
281,279,1,999,1008,9,5.66,9.2,13.6
281,280,0,495,543,48,6.87,10.96,14.92
281,280,1,695,702,7,13.51,14.05,14.95
281,280,2,861,864,3,14.52,14.61,14.72
281,280,3,953,990,37,9.42,11.39,14.65
281,280,4,1020,1033,13,6.79,9.22,13.75
281,282,0,721,730,9,4.02,8.57,14.33
281,284,0,852,854,2,14.59,14.72,14.89
281,284,1,965,976,11,7.2,10.5,14.98
282,270,0,516,522,6,12.49,13.32,14.5
282,270,1,771,784,13,9.22,11.42,14.51
282,270,2,878,889,11,2.63,8.44,14.82
282,270,3,1046,1051,5,8.24,10.64,13.68
282,271,0,942,955,13,8.22,10.69,14.3
282,272,0,876,878,2,14.71,14.81,14.92
282,273,0,675,676,1,14.78,14.84,14.9
282,274,0,690,748,58,4.45,10.7,14.64
282,274,1,782,791,9,2.04,7.64,13.71
282,275,0,566,576,10,4.03,8.41,13.51
282,276,0,813,818,5,8.22,10.08,12.3
282,276,1,989,990,1,14.62,14.76,14.91
282,277,0,563,572,9,0.77,7.74,14.7
282,278,0,482,492,10,9.02,11.11,13.94
282,278,1,891,904,13,10.02,11.85,14.92
282,279,0,642,650,8,13.77,14.18,14.93
282,279,1,906,914,8,3.78,9.17,14.87
282,279,2,1027,1034,7,11.92,13.02,14.58
282,280,0,656,668,12,5.5,9.66,14.81
282,281,0,721,730,9,4.02,8.57,14.33
282,283,0,744,753,9,1.76,7.51,13.44
282,283,1,1031,1035,4,12.62,13.44,14.74
283,270,0,870,876,6,9.12,11.09,13.5
283,270,1,1004,1018,14,1.59,7.72,14.98
283,271,0,617,635,18,12.16,13.09,14.61
283,272,0,834,854,20,0.94,8.65,14.87
283,273,0,469,474,5,1.27,7.57,13.9
283,273,1,1008,1014,6,8.27,10.37,12.86
283,274,0,749,759,10,7.78,10.67,14.51
283,274,1,862,869,7,7.92,10.23,13.29
283,275,0,921,931,10,4.87,9.35,14.87
283,276,0,469,473,4,4.43,8.03,12.61
283,276,1,578,587,9,4.31,9.48,14.83
283,276,2,687,691,4,10.93,12.02,13.27
283,277,0,761,761,0,10.64,10.64,10.64
283,278,0,797,797,0,14.58,14.58,14.58
283,279,0,778,785,7,4.55,8.86,14.7
283,279,1,1022,1025,3,14.23,14.48,14.83
283,282,0,744,753,9,1.76,7.51,13.44
283,282,1,1031,1035,4,12.62,13.44,14.74
283,284,0,758,766,8,8.05,10.61,14.4
284,270,0,790,800,10,8.31,10.8,14.1
284,271,0,784,803,19,7.24,10.19,14.63
284,272,0,727,734,7,13.42,13.88,14.52
284,273,0,831,864,33,1.49,8.35,14.76
284,274,0,465,470,5,14.44,14.6,14.85
284,275,0,444,462,18,8.84,11.08,14.51
284,275,1,643,658,15,3.37,8.26,14.51
284,275,2,1028,1039,11,2.24,7.5,13.26
284,276,0,1023,1037,14,7.46,10.46,14.73
284,277,0,761,761,0,3.9,3.9,3.9
284,277,1,830,833,3,13.94,14.3,14.87
284,277,2,881,908,27,9.2,10.71,14.84
284,278,0,557,581,24,5.7,9.54,14.86
284,278,1,794,794,0,14.54,14.54,14.54
284,279,0,597,607,10,2.86,7.94,14.16
284,279,1,839,839,0,14.92,14.92,14.92
284,279,2,959,968,9,0.71,7.7,14.73
284,280,0,826,857,31,7.56,10.45,14.93
284,281,0,852,854,2,14.59,14.72,14.89
284,281,1,965,976,11,7.2,10.5,14.98
284,283,0,758,766,8,8.05,10.61,14.4
285,124,0,736,751,15,1.9,7.72,14.36
285,140,0,715,720,5,13.21,13.88,14.77
285,286,0,951,961,10,1.89,7.69,14.56
285,287,0,428,445,17,2.24,6.21,14.9
285,287,1,536,545,9,6.55,10.02,14.71
285,287,2,844,850,6,10.33,11.71,13.37
285,289,0,546,563,17,4.67,9,14.73
285,289,1,719,726,7,13.19,13.77,14.6
285,289,2,897,897,0,9.91,9.91,9.91
285,290,0,861,868,7,12.23,13.02,14.13
285,290,1,883,898,15,8.64,10.84,14.09
285,290,2,993,1005,12,7.69,10.53,14.38
285,291,0,444,475,31,1.73,8.78,14.91
285,292,0,475,490,15,6.08,9.78,14.91
285,292,1,555,577,22,4.78,9,14.74
285,292,2,634,639,5,14.07,14.38,14.85
285,293,0,514,520,6,13.41,13.98,14.84
285,294,0,641,649,8,5.37,9.08,13.52
285,294,1,878,899,21,5.85,9.43,14.69
285,295,0,428,433,5,11.81,13.27,14.97
285,295,1,475,484,9,3.08,8.37,14.75
285,295,2,525,548,23,11.36,12.55,14.55
285,295,3,882,906,24,10.33,12,14.94
285,295,4,929,937,8,6,9.48,13.72
285,298,0,730,735,5,12.39,13.24,14.49
285,298,1,908,923,15,7.31,10.31,14.66
285,298,2,964,981,17,10.66,12.14,14.62
285,299,0,808,817,9,2.9,8.38,14.75
286,56,0,935,943,8,7.88,10.42,13.87
286,77,0,824,827,3,7.09,10.98,13.53
286,178,0,887,895,8,11.25,12.65,14.69
286,285,0,951,961,10,1.89,7.69,14.56
286,287,0,508,526,18,1.22,7.31,13.58
286,287,1,690,707,17,7.58,10.35,14.19
286,287,2,714,741,27,9.11,11.33,14.97
286,287,3,879,885,6,13.96,14.27,14.7
286,287,4,1042,1051,9,1.76,8.02,14.34
286,288,0,490,493,3,14.33,14.59,14.97
286,288,1,1037,1060,23,2.64,10.13,14.99
286,289,0,502,523,21,1.68,9.05,14.48
286,289,1,919,927,8,6.16,9.78,14.13
286,290,0,507,519,12,10.21,12.72,14.97
286,290,1,627,634,7,10.01,11.81,14.27
286,290,2,1011,1018,7,13.84,14.25,14.83
286,292,0,538,547,9,1.3,7.75,14.23
286,293,0,857,866,9,7.2,10.24,14.42
286,295,0,1017,1025,8,1.55,7.83,14.63
286,296,0,545,556,11,4.12,8.36,13.56
286,296,1,720,726,6,13.63,14.14,14.78
286,296,2,843,863,20,4.96,9.07,14.45
286,296,3,884,890,6,13.66,14.07,14.65
286,297,0,669,688,19,6.42,9.52,13.91
286,297,1,697,707,10,8.86,10.97,13.88
286,307,0,727,736,9,3.46,8.73,14.87
287,178,0,883,890,7,9.53,11.59,14.37
287,285,0,444,445,1,12.03,13.47,14.9
287,285,1,536,545,9,6.55,10.02,14.71
287,285,2,844,850,6,10.33,11.71,13.37
287,286,0,508,526,18,1.22,7.41,13.58
287,286,1,690,707,17,7.58,10.25,14.19
287,286,2,714,741,27,9.11,11.33,14.97
287,286,3,879,885,6,13.96,14.27,14.7
287,286,4,1042,1051,9,1.76,8.02,14.34
287,288,0,1028,1037,9,13.92,14.3,14.96
287,288,1,1042,1052,10,11.75,13.07,14.41
287,289,0,508,534,26,6.08,10.41,14.98
287,290,0,476,509,33,2.26,8.4,14.66
287,290,1,513,521,8,10.39,12.27,14.96
287,290,2,945,984,39,3.14,9.12,14.75
287,291,0,670,684,14,3.24,7.98,13.57
287,292,0,645,655,10,2.83,7.83,13.34
287,293,0,468,480,12,11.69,13.05,14.96
287,293,1,651,658,7,6.24,9.74,14.44
287,293,2,841,845,4,14.36,14.55,14.83
287,294,0,601,645,44,1.52,10.8,14.82
287,294,1,723,734,11,8.21,10.54,13.93
287,295,0,444,450,6,13.03,13.6,14.44
287,295,1,772,797,25,4.53,8.83,14.89
287,295,2,854,861,7,4.53,8.94,14.37
287,295,3,1071,1073,2,9.93,11.78,13.63
287,296,0,715,726,11,3.47,8.45,14.76
287,296,1,873,883,10,6.03,9.45,14.48
287,296,2,1030,1039,9,8.81,11.08,14.24
287,297,0,697,704,7,9.47,11.3,13.96
287,298,0,672,676,4,11.54,12.78,14.28
287,298,1,886,887,1,14.81,14.88,14.94
287,298,2,989,999,10,4.98,8.95,14.28
287,299,0,481,489,8,4.74,8.85,14.14
287,299,1,568,575,7,5.81,8.79,12.42
287,299,2,655,663,8,6.79,10.21,15
287,299,3,742,749,7,7.5,10.07,13.35
287,299,4,829,836,7,8.54,10.96,14.43
287,299,5,916,923,7,9.53,11.72,14.63
287,299,6,1004,1010,6,10.11,11.81,14.44
287,307,0,725,732,7,1.32,7.58,14.31
288,56,0,836,849,13,10.91,12.27,14.38
288,286,0,490,493,3,14.33,14.59,14.97
288,286,1,1037,1061,24,2.64,10.6,14.99
288,287,0,1028,1037,9,13.92,14.3,14.96
288,287,1,1042,1052,10,11.75,13.12,14.41
288,289,0,449,472,23,4.24,8.69,14.75
288,290,0,577,599,22,11.19,12.44,14.48
288,292,0,688,694,6,11.43,12.59,14.09
288,292,1,729,744,15,9.16,11.26,14.57
288,293,0,539,561,22,5.97,10.47,14.74
288,294,0,508,510,2,14.69,14.8,14.9
288,294,1,562,572,10,9.08,11.51,14.78
288,294,2,988,994,6,12.21,13.04,14.31
288,298,0,457,473,16,5.13,9.72,14.94
288,298,1,484,500,16,11.83,12.89,14.76
288,298,2,760,770,10,2.68,8,14.69
288,299,0,431,458,27,0.42,8.01,14.84
288,299,1,691,697,6,12.71,13.69,14.97
288,299,2,929,950,21,10.53,11.97,14.38
288,299,3,987,999,12,6.55,9.68,13.78
289,124,0,694,694,0,12.28,12.28,12.28
289,124,1,708,720,12,1.34,7.37,13.46
289,140,0,702,714,12,1.46,7.3,13.23
289,140,1,745,749,4,8.41,10.79,13.53
289,285,0,546,563,17,4.67,9,14.73
289,285,1,719,726,7,13.19,13.77,14.6
289,285,2,897,897,0,9.91,9.91,9.91
289,286,0,502,523,21,1.68,8.97,14.48
289,286,1,919,927,8,6.16,9.78,14.13
289,287,0,508,534,26,6.08,10.41,14.98
289,290,0,509,524,15,0.49,7.53,14.58
289,290,1,583,589,6,12.45,13.28,14.62
289,290,2,701,711,10,1.98,7.79,14.74
289,290,3,898,898,0,9.16,9.16,9.16
289,290,4,904,913,9,4.65,8.94,14.36
289,292,0,560,565,5,13.94,14.24,14.7
289,292,1,927,936,9,1.7,8.03,14.65
289,293,0,577,577,0,14.94,14.94,14.94
289,295,0,898,898,0,10.86,10.86,10.86
289,297,0,956,995,39,2.32,7.03,14.59
289,298,0,1000,1008,8,2.84,7.91,13.98
289,299,0,973,992,19,3.22,8.23,14.74
290,56,0,919,923,4,10.64,11.98,14
290,124,0,695,698,3,11.11,13.67,14.95
290,140,0,699,711,12,4.27,8.5,13.88
290,178,0,816,816,0,10.63,10.63,10.63
290,285,0,861,868,7,12.23,13.02,14.13
290,285,1,883,898,15,8.64,10.84,14.09
290,285,2,993,1005,12,7.69,10.53,14.38
290,285,3,1071,1074,3,11.41,13.02,14.85
290,286,0,507,519,12,10.21,12.62,14.97
290,286,1,627,634,7,10.01,11.81,14.27
290,286,2,1011,1018,7,13.84,14.25,14.83
290,287,0,476,509,33,2.26,8.25,14.66
290,287,1,513,521,8,10.39,12.27,14.96
290,287,2,945,984,39,3.14,9.1,14.75
290,288,0,577,599,22,11.19,12.44,14.48
290,289,0,509,524,15,0.49,7.53,14.58
290,289,1,583,589,6,12.45,13.28,14.62
290,289,2,701,711,10,1.98,7.79,14.74
290,289,3,898,898,0,9.16,9.16,9.16
290,289,4,904,913,9,4.65,8.94,14.36
290,292,0,833,840,7,3.29,8.48,14.55
290,293,0,463,475,12,4.08,9.42,14.8
290,293,1,773,780,7,3.34,8.38,13.84
290,293,2,847,849,2,14,14.35,14.79
290,294,0,525,547,22,5.74,9.31,14.56
290,294,1,827,836,9,1.16,7.25,13.6
290,294,2,885,896,11,2.45,8.44,14.94
290,295,0,597,611,14,2.54,8.42,14.86
290,295,1,743,746,3,13.27,13.79,14.48
290,295,2,890,903,13,1.95,7.68,14.19
290,295,3,1023,1028,5,11.32,12.65,14.82
290,295,4,1037,1039,2,14.63,14.73,14.84
290,296,0,829,838,9,12.34,13.19,14.62
290,297,0,600,611,11,8.8,10.89,14.02
290,297,1,768,776,8,6.23,9.3,12.96
290,298,0,722,727,5,9.69,11.74,14.83
290,299,0,479,488,9,7.6,11.43,14.98
290,299,1,1014,1018,4,13.18,13.69,14.42
291,56,0,831,834,3,14.39,14.61,14.93
291,77,0,910,928,18,1.94,7.42,13.57
291,285,0,444,475,31,1.73,8.9,14.91
291,287,0,670,684,14,3.24,7.98,13.57
291,292,0,424,439,15,10.64,12.01,14.53
291,292,1,812,820,8,10,11.74,14.51
291,292,2,981,995,14,1.28,7.32,13.37
291,293,0,608,638,30,2.9,8.47,14.5
291,294,0,690,699,9,6.61,9.62,13.84
291,294,1,899,921,22,3.62,8.32,14.32
291,294,2,926,937,11,4.74,8.71,13.75
291,295,0,481,490,9,9.79,11.95,14.95
291,295,1,815,826,11,3.04,8.25,14.76
291,297,0,640,663,23,9.07,11.28,14.83
291,297,1,830,852,22,10.15,12.55,14.95
291,298,0,620,632,12,8.01,10.68,14.74
291,298,1,929,954,25,2.48,6.61,14.8
291,299,0,773,781,8,10.65,12.1,14.36
291,299,1,841,855,14,3.89,8.39,14.12
291,307,0,699,699,0,7.06,7.06,7.06
292,56,0,954,955,1,13.95,14.2,14.44
292,77,0,949,955,6,0.6,6.74,14.7
292,140,0,753,761,8,3.67,8.02,13.15
292,285,0,475,490,15,6.08,9.78,14.91
292,285,1,555,577,22,4.78,9,14.74
292,285,2,634,639,5,14.07,14.38,14.85
292,286,0,538,547,9,1.3,7.75,14.23
292,287,0,645,655,10,2.83,7.83,13.34
292,288,0,688,694,6,11.43,12.59,14.09
292,288,1,729,744,15,9.16,11.26,14.57
292,289,0,560,565,5,13.94,14.24,14.7
292,289,1,927,936,9,1.7,8.03,14.65
292,290,0,833,840,7,3.29,8.48,14.55
292,291,0,812,820,8,10,11.74,14.51
292,291,1,981,995,14,1.28,7.32,13.37
292,293,0,886,893,7,0.94,7.34,13.79
292,294,0,648,652,4,13.47,14.03,14.75
292,294,1,835,835,0,14.96,14.96,14.96
292,294,2,950,958,8,1.76,8.32,14.46
292,295,0,476,482,6,9.79,11.7,14.62
292,295,1,546,554,8,13.36,14.01,14.98
292,295,2,758,763,5,10.51,11.73,13.38
292,295,3,821,828,7,12.66,13.34,14.32
292,295,4,948,956,8,0.43,7.14,13.14
292,296,0,499,537,38,0.36,7.52,14.65
292,296,1,664,664,0,9.5,9.5,9.5
292,296,2,835,846,11,6.34,9.63,14.32
292,298,0,856,863,7,4.98,9.32,14.62
292,299,0,673,714,41,2.49,8.58,14.57
292,299,1,717,723,6,12.45,13.45,14.93
293,178,0,942,955,13,5.11,8.39,14.8
293,285,0,514,520,6,13.41,13.98,14.84
293,286,0,452,457,5,5.18,9.65,14.34
293,286,1,857,866,9,7.2,10.24,14.42
293,287,0,468,480,12,11.69,12.99,14.96
293,287,1,651,658,7,6.24,9.74,14.44
293,287,2,841,845,4,14.36,14.55,14.83
293,288,0,539,561,22,5.97,10.35,14.74
293,289,0,577,577,0,14.94,14.94,14.94
293,290,0,454,475,21,2.72,8.62,14.8
293,290,1,773,780,7,3.34,8.38,13.84
293,290,2,847,849,2,14,14.35,14.79
293,291,0,608,638,30,2.9,8.47,14.5
293,292,0,886,893,7,0.94,7.34,13.79
293,294,0,558,566,8,0.66,7.52,14.01
293,294,1,656,664,8,0.66,7.28,13.39
293,294,2,853,860,7,6.94,10.08,14.66
293,294,3,989,1006,17,3.15,9.08,14.65
293,295,0,586,594,8,4.91,8.53,12.83
293,295,1,722,724,2,14.31,14.51,14.71
293,295,2,842,846,4,13.35,13.9,14.54
293,296,0,585,587,2,14.23,14.44,14.74
293,296,1,750,756,6,11.21,12.29,13.67
293,296,2,760,775,15,10.26,12.07,14.95
293,296,3,855,865,10,4.21,8.52,13.72
293,296,4,951,973,22,2.42,7.02,14.89
293,297,0,633,644,11,3.15,8.69,14.99
293,297,1,777,794,17,5.81,9.48,14.85
293,298,0,624,631,7,4.54,8.91,14.6
293,298,1,868,875,7,5.66,9.57,14.3
293,299,0,490,505,15,1.76,7.78,14.5
293,299,1,651,656,5,10.54,12.06,14.09
293,299,2,820,827,7,6.55,10.07,14.63
293,307,0,749,756,7,1.21,6.95,12.7
293,307,1,804,805,1,14.89,14.9,14.92
294,56,0,945,954,9,4.17,8.48,14.01
294,77,0,909,919,10,2.81,7.84,13.39
294,77,1,937,955,18,1.52,6.81,14.22
294,124,0,800,807,7,10.24,11.73,13.89
294,285,0,641,649,8,5.37,9.08,13.52
294,285,1,878,899,21,5.85,9.43,14.69
294,287,0,601,645,44,1.52,10.81,14.82
294,287,1,723,734,11,8.21,10.54,13.93
294,288,0,508,510,2,14.69,14.8,14.9
294,288,1,562,572,10,9.08,11.51,14.78
294,288,2,988,994,6,12.21,13.04,14.31
294,290,0,525,547,22,5.74,9.27,14.56
294,290,1,827,836,9,1.16,7.25,13.6
294,290,2,885,896,11,2.45,8.44,14.94
294,291,0,690,699,9,6.61,9.62,13.84
294,291,1,899,921,22,3.62,8.32,14.32
294,291,2,926,937,11,4.74,8.48,13.75
294,292,0,648,652,4,13.47,14.03,14.75
294,292,1,835,835,0,14.96,14.96,14.96
294,292,2,950,958,8,1.76,8.32,14.46
294,293,0,558,566,8,0.66,7.52,14.01
294,293,1,656,664,8,0.66,7.28,13.39
294,293,2,853,860,7,6.94,10.08,14.66
294,293,3,989,1006,17,3.15,9.36,14.65
294,295,0,469,475,6,6.51,9.53,13.18
294,295,1,860,896,36,7.16,10.16,14.76
294,295,2,943,971,28,4.87,8.87,14.29
294,296,0,469,481,12,5.53,9.41,14.37
294,296,1,816,832,16,5.96,9.36,14.17
294,298,0,675,681,6,8.52,11.28,14.59
294,298,1,801,813,12,0.06,7.1,13.23
294,298,2,930,937,7,2.44,8,13.76
294,299,0,574,581,7,4.19,8.04,12.53
294,299,1,991,992,1,14.64,14.74,14.85
294,307,0,699,699,0,14.4,14.4,14.4
294,307,1,721,730,9,2.8,8.06,14.49
295,56,0,938,951,13,2.69,7.75,13.58
295,77,0,944,955,11,5.05,8.05,13.79
295,140,0,759,766,7,5.62,9.29,14.18
295,285,0,475,484,9,3.08,8.37,14.75
295,285,1,525,548,23,11.36,12.55,14.55
295,285,2,882,906,24,10.33,12,14.94
295,285,3,929,937,8,6,9.48,13.72
295,286,0,1017,1025,8,1.55,7.83,14.63
295,287,0,772,797,25,4.53,8.65,14.89
295,287,1,854,861,7,4.53,8.94,14.37
295,289,0,898,898,0,10.86,10.86,10.86
295,290,0,597,611,14,2.54,8.42,14.86
295,290,1,743,746,3,13.27,13.79,14.48
295,290,2,890,903,13,1.95,7.68,14.19
295,290,3,1023,1028,5,11.32,12.65,14.82
295,291,0,481,490,9,9.79,11.95,14.95
295,291,1,815,826,11,3.04,8.25,14.76
295,292,0,476,482,6,9.79,11.7,14.62
295,292,1,546,554,8,13.36,14.01,14.98
295,292,2,758,763,5,10.51,11.73,13.38
295,292,3,821,828,7,12.66,13.34,14.32
295,292,4,948,956,8,0.43,7.14,13.14
295,293,0,586,594,8,4.91,8.53,12.83
295,293,1,722,724,2,14.31,14.51,14.71
295,293,2,842,846,4,13.35,13.9,14.54
295,294,0,470,475,5,6.51,8.92,12.44
295,294,1,860,896,36,7.16,10.16,14.76
295,294,2,943,971,28,4.87,8.87,14.29
295,296,0,470,473,3,5.03,8.88,12.73
295,296,1,579,587,8,3.22,7.09,13.57
295,296,2,993,1004,11,10.1,12.05,14.28
295,297,0,597,606,9,6.18,9.3,13.46
295,297,1,820,824,4,13.23,13.7,14.3
295,298,0,686,693,7,2.89,7.76,13.09
295,298,1,768,774,6,6.18,9.26,13.44
295,299,0,513,520,7,2.84,8.09,14.56
296,17,0,617,650,33,7.71,9.99,14.92
296,178,0,938,955,17,11.18,12.28,14.89
296,286,0,545,556,11,4.12,8.36,13.56
296,286,1,720,726,6,13.63,14.14,14.78
296,286,2,843,863,20,4.96,9.07,14.45
296,286,3,884,890,6,13.66,14.07,14.65
296,287,0,715,726,11,3.47,8.45,14.76
296,287,1,873,883,10,6.03,9.45,14.48
296,287,2,1030,1039,9,8.81,11.08,14.24
296,289,0,661,661,0,8.05,8.05,8.05
296,290,0,829,838,9,12.34,13.19,14.62
296,292,0,499,537,38,0.36,7.52,14.65
296,292,1,664,664,0,9.5,9.5,9.5
296,292,2,835,846,11,6.34,9.63,14.32
296,293,0,585,587,2,14.23,14.44,14.74
296,293,1,750,756,6,11.21,12.29,13.67
296,293,2,760,775,15,10.26,12.07,14.95
296,293,3,855,865,10,4.21,8.52,13.72
296,293,4,951,973,22,2.42,7.05,14.89
296,294,0,469,481,12,5.53,9.41,14.37
296,294,1,816,832,16,5.96,9.36,14.17
296,295,0,458,473,15,1.59,5.82,12.73
296,295,1,579,587,8,3.22,7.09,13.57
296,295,2,993,1004,11,10.1,11.96,14.28
296,299,0,664,677,13,2.81,7.6,14.63
296,307,0,736,756,20,2.26,8.88,14.99
297,5,0,859,859,0,7.99,7.99,7.99
297,5,1,865,880,15,7.17,10.12,14.56
297,130,0,857,857,0,13.99,13.99,13.99
297,176,0,880,880,0,11.32,11.32,11.32
297,286,0,669,688,19,6.42,9.52,13.91
297,286,1,697,707,10,8.86,10.97,13.88
297,287,0,697,704,7,9.47,11.3,13.96
297,289,0,956,995,39,2.32,7.09,14.59
297,290,0,600,611,11,8.8,10.89,14.02
297,290,1,768,776,8,6.23,9.3,12.96
297,290,2,952,952,0,13.29,13.29,13.29
297,291,0,640,663,23,9.07,11.28,14.83
297,291,1,830,852,22,10.15,12.55,14.95
297,293,0,633,644,11,3.15,8.69,14.99
297,293,1,777,794,17,5.81,9.48,14.85
297,295,0,597,606,9,6.18,9.3,13.46
297,295,1,820,824,4,13.23,13.7,14.3
297,298,0,1007,1014,7,9.46,11.24,13.61
297,299,0,845,852,7,2.35,8.08,14.82
297,299,1,972,989,17,4.82,8.71,14.33
298,77,0,927,932,5,11.14,12.41,14.3
298,124,0,723,737,14,4.53,8.87,14.6
298,124,1,803,812,9,12.86,13.52,14.95
298,178,0,817,817,0,11.51,11.51,11.51
298,178,1,871,883,12,1.7,7.61,14.37
298,285,0,730,735,5,12.39,13.24,14.49
298,285,1,908,923,15,7.31,10.31,14.66
298,285,2,964,981,17,10.66,12.14,14.62
298,287,0,672,676,4,11.54,12.78,14.28
298,287,1,886,887,1,14.81,14.88,14.94
298,287,2,989,999,10,4.98,8.95,14.28
298,288,0,466,473,7,5.13,9.38,14.94
298,288,1,484,500,16,11.83,12.89,14.76
298,288,2,760,770,10,2.68,8,14.69
298,289,0,466,470,4,11.22,12.76,14.8
298,289,1,1000,1008,8,2.84,7.91,13.98
298,290,0,722,727,5,9.69,11.74,14.83
298,291,0,620,632,12,8.01,10.68,14.74
298,291,1,929,954,25,2.48,6.58,14.8
298,292,0,856,863,7,4.98,9.32,14.62
298,293,0,624,631,7,4.54,8.91,14.6
298,293,1,868,875,7,5.66,9.57,14.3
298,294,0,675,681,6,8.52,11.28,14.59
298,294,1,801,813,12,0.06,7.1,13.23
298,294,2,930,937,7,2.44,8,13.76
298,295,0,686,693,7,2.89,7.76,13.09
298,295,1,768,774,6,6.18,9.26,13.44
298,297,0,1007,1014,7,9.46,11.24,13.61
298,299,0,555,561,6,7.83,10.88,14.76
299,77,0,864,871,7,11.92,12.92,14.31
299,285,0,808,817,9,2.9,8.38,14.75
299,287,0,481,489,8,4.74,8.85,14.14
299,287,1,568,575,7,5.81,8.79,12.42
299,287,2,655,663,8,6.79,10.21,15
299,287,3,742,749,7,7.5,10.07,13.35
299,287,4,829,836,7,8.54,10.96,14.43
299,287,5,916,923,7,9.53,11.72,14.63
299,287,6,1004,1010,6,10.11,11.81,14.44
299,288,0,691,697,6,12.71,13.69,14.97
299,288,1,929,950,21,10.53,12.05,14.38
299,288,2,987,999,12,6.55,9.68,13.78
299,289,0,973,992,19,3.22,8.48,14.74
299,290,0,479,488,9,7.6,11.28,14.98
299,290,1,1014,1018,4,13.18,13.69,14.42
299,291,0,773,781,8,10.65,12.1,14.36
299,291,1,841,855,14,3.89,8.39,14.12
299,292,0,673,714,41,2.49,8.63,14.57
299,292,1,717,723,6,12.45,13.45,14.93
299,293,0,490,505,15,1.76,7.78,14.5
299,293,1,651,656,5,10.54,12.06,14.09
299,293,2,820,826,6,6.55,9.42,13.65
299,294,0,574,581,7,4.19,8.04,12.53
299,294,1,991,992,1,14.64,14.74,14.85
299,295,0,513,520,7,2.84,8.09,14.56
299,296,0,664,677,13,2.81,7.6,14.63
299,297,0,845,852,7,2.35,8.08,14.82
299,297,1,972,989,17,4.82,8.79,14.33
299,298,0,555,561,6,7.83,10.88,14.76
300,245,0,977,979,2,13.96,14.24,14.5
300,301,0,543,546,3,14.48,14.66,14.93
300,301,1,693,702,9,0.58,7.38,14.44
300,301,2,845,858,13,6.04,9.68,14.89
300,302,0,905,920,15,5.75,9.51,14.54
300,303,0,713,726,13,9.81,12,14.95
300,303,1,859,867,8,1.21,7.23,12.71
300,303,2,1034,1043,9,10.74,12.13,14.58
300,304,0,519,531,12,1.25,7.89,14.64
300,304,1,996,1005,9,10.05,11.99,14.71
300,305,0,530,538,8,6.82,10.07,14.04
300,305,1,621,630,9,3.17,8.55,14.82
300,305,2,985,1020,35,5.88,9.54,14.94
300,306,0,473,500,27,4.55,11.58,14.98
300,307,0,622,628,6,9.58,11.52,14.15
300,307,1,841,849,8,5.83,9.47,14.92
300,309,0,559,566,7,3.09,7.61,12.69
300,309,1,843,846,3,5.87,9.47,13.51
300,311,0,503,511,8,7.92,10.63,14.58
300,311,1,804,813,9,0.63,7.2,13.78
300,312,0,817,835,18,2.33,9.71,14.39
300,312,1,838,849,11,13.29,13.79,14.56
300,314,0,696,717,21,3.69,9.11,14.9
300,343,0,976,987,11,10.73,12.13,14.27
301,66,0,961,971,10,8.31,11.47,14.63
301,300,0,543,546,3,14.48,14.66,14.93
301,300,1,692,702,10,0.58,8.06,14.87
301,300,2,845,858,13,6.04,9.68,14.89
301,302,0,804,812,8,1.53,7.49,13.2
301,303,0,866,871,5,8.78,10.6,12.79
301,303,1,875,876,1,14.97,14.98,14.99
301,304,0,492,501,9,12.33,13.15,14.39
301,304,1,896,896,0,14.78,14.78,14.78
301,305,0,786,797,11,3.97,8.47,13.99
301,305,1,916,923,7,9.77,11.77,14.55
301,306,0,552,567,15,8.04,10.61,14.58
301,307,0,659,664,5,9.92,11.65,14.09
301,307,1,836,836,0,12.14,12.14,12.14
301,307,2,839,849,10,9.92,11.61,14.11
301,307,3,959,967,8,9.02,11.35,14.47
301,308,0,486,507,21,7.08,10.15,14.75
301,309,0,843,847,4,11.78,12.56,14.01
301,310,0,748,760,12,13.66,14.14,14.89
301,310,1,783,794,11,7.83,10.65,14.19
301,310,2,905,911,6,12.83,13.58,14.91
301,311,0,478,488,10,11.17,12.58,14.61
301,311,1,628,636,8,5.67,9.52,14.35
301,311,2,937,946,9,2.14,8.16,14.4
301,312,0,454,461,7,9.52,11.45,14.39
301,312,1,848,852,4,9.95,11.49,14.25
301,313,0,631,642,11,1.85,7.94,14.71
301,313,1,703,707,4,13.61,14.16,14.9
301,314,0,524,528,4,11.48,12.52,13.77
301,314,1,695,698,3,14.03,14.49,14.96
302,3,0,957,966,9,4.82,9.09,14.26
302,300,0,905,920,15,5.75,9.19,14.54
302,301,0,804,812,8,1.53,7.49,13.2
302,303,0,534,595,61,4.28,9.41,14.82
302,304,0,434,446,12,6.87,9.86,14.33
302,304,1,571,574,3,14.19,14.41,14.69
302,304,2,585,596,11,8.64,11.07,14.66
302,305,0,550,589,39,2.95,9.64,14.79
302,305,1,705,716,11,7.43,10.25,14.6
302,306,0,622,629,7,8.54,10.86,14.09
302,306,1,971,985,14,5.77,9.56,14.63
302,306,2,1055,1056,1,13.38,14.03,14.68
302,307,0,599,607,8,7.72,10.71,14.86
302,308,0,547,556,9,2.09,7.81,14.15
302,308,1,746,747,1,14.63,14.8,14.97
302,308,2,891,910,19,12.97,13.76,14.94
302,309,0,512,520,8,7,9.9,13.96
302,309,1,1025,1031,6,7.88,10.39,13.56
302,310,0,541,546,5,13.62,14.14,14.87
302,310,1,827,835,8,11.71,13.01,14.81
302,311,0,556,563,7,1.6,7.01,12.48
302,311,1,671,680,9,8.74,10.99,14.5
302,311,2,872,882,10,2.34,7.65,13.74
302,312,0,493,503,10,3.83,8.47,13.76
302,312,1,979,993,14,0.6,7.64,14.64
302,313,0,849,855,6,2.56,7.5,12.06
302,314,0,464,471,7,2.65,8.2,14.32
302,314,1,725,726,1,14.87,14.9,14.92
303,245,0,955,955,0,12.93,12.93,12.93
303,245,1,1004,1012,8,4.11,8.83,14.87
303,300,0,713,726,13,9.81,12.14,14.95
303,300,1,859,867,8,1.21,7.23,12.71
303,300,2,1034,1042,8,10.74,11.96,14.58
303,301,0,866,871,5,8.78,10.6,12.79
303,301,1,875,876,1,14.97,14.98,14.99
303,302,0,534,595,61,4.28,9.33,14.82
303,304,0,568,591,23,4.22,8.21,14.68
303,304,1,786,795,9,5.21,9.22,14.06
303,305,0,555,585,30,0.58,8.46,14.67
303,305,1,1029,1036,7,11.26,12.56,14.58
303,306,0,981,986,5,11.51,12.37,13.43
303,307,0,597,601,4,13.23,14.04,14.94
303,307,1,894,905,11,8.69,11.15,14.78
303,308,0,550,558,8,2.47,7.7,13.42
303,308,1,815,817,2,14.39,14.65,14.95
303,309,0,665,674,9,1.46,8.05,14.95
303,309,1,889,897,8,9.64,11.73,14.62
303,311,0,557,565,8,1.38,7.81,14.7
303,311,1,846,851,5,10.84,12.16,13.83
303,312,0,674,680,6,10.65,12.2,14.97
303,312,1,974,974,0,14.97,14.97,14.97
303,313,0,1011,1019,8,8.36,11.11,14.24
303,314,0,632,639,7,5.48,9.16,14.07
303,314,1,712,719,7,5.3,9.01,13.79
304,93,0,970,982,12,7.26,9.99,14.7
304,245,0,981,989,8,7.51,10.44,14.35
304,300,0,519,531,12,1.25,7.89,14.64
304,300,1,996,1005,9,10.05,11.99,14.71
304,301,0,492,501,9,12.33,13.15,14.39
304,301,1,896,896,0,14.78,14.78,14.78
304,302,0,571,574,3,14.19,14.41,14.69
304,302,1,585,596,11,8.64,11.07,14.66
304,303,0,568,591,23,4.22,8.47,14.68
304,303,1,786,795,9,5.21,9.22,14.06
304,305,0,574,583,9,13.18,13.81,14.85
304,305,1,588,595,7,12.03,13.17,14.98
304,305,2,1000,1009,9,10.02,11.99,14.87
304,306,0,761,773,12,7.51,10.04,14.17
304,308,0,476,485,9,13.33,13.89,14.78
304,308,1,533,547,14,1.74,7.82,14.81
304,309,0,623,632,9,9.57,11.5,14.4
304,311,0,868,874,6,12.13,13.05,14.56
304,311,1,1024,1033,9,10.07,12.05,14.38
304,312,0,626,658,32,6.08,9.63,14.95
304,314,0,661,666,5,13.59,14.13,14.94
304,314,1,779,789,10,1.12,7.67,14.99
305,300,0,530,538,8,6.82,10.07,14.04
305,300,1,621,630,9,3.17,8.55,14.82
305,300,2,985,1020,35,5.88,9.52,14.94
305,301,0,786,797,11,3.97,8.94,13.99
305,301,1,916,923,7,9.77,11.77,14.55
305,301,2,1064,1073,9,7.41,11.2,14.67
305,302,0,550,589,39,2.95,9.74,14.79
305,302,1,705,716,11,7.43,10.25,14.6
305,303,0,555,585,30,0.58,8.26,14.67
305,303,1,1029,1036,7,11.26,12.56,14.58
305,304,0,574,583,9,13.18,13.81,14.85
305,304,1,588,595,7,12.03,13.17,14.98
305,304,2,1000,1009,9,10.02,11.99,14.87
305,306,0,808,816,8,6.26,9.64,14.94
305,306,1,901,909,8,7.15,10.13,14.22
305,307,0,484,496,12,3.85,9.4,14.85
305,307,1,616,629,13,4.2,8.61,14.16
305,307,2,638,670,32,3.86,8.59,14.93
305,307,3,929,938,9,3.82,8.73,14.4
305,308,0,544,554,10,9.84,11.72,14.46
305,310,0,540,551,11,5.37,8.88,13.54
305,310,1,663,675,12,2.54,7.8,14.07
305,310,2,739,798,59,8.12,10.83,14.84
305,311,0,557,565,8,6.83,9.87,13.98
305,311,1,894,903,9,3.44,8.22,13.71
305,312,0,600,610,10,2.02,8.15,14.38
305,313,0,928,937,9,1.61,8.03,14.81
305,314,0,500,501,1,14.95,14.96,14.97
305,314,1,545,555,10,7.81,10.3,13.72
305,314,2,1073,1073,0,14.54,14.54,14.54
305,343,0,982,992,10,1,8.18,13.92
306,300,0,476,500,24,4.55,11.28,14.98
306,301,0,552,567,15,8.04,10.61,14.58
306,302,0,622,629,7,8.54,10.86,14.09
306,302,1,971,985,14,5.77,9.56,14.63
306,303,0,981,986,5,11.51,12.37,13.43
306,304,0,761,773,12,7.51,10.2,14.17
306,305,0,808,816,8,6.26,9.64,14.94
306,305,1,901,909,8,7.15,10.13,14.22
306,307,0,943,950,7,7.51,10.09,13.67
306,308,0,651,668,17,8.44,10.65,14.28
306,310,0,815,826,11,4.37,8.9,14.98
306,310,1,852,877,25,11.07,12.47,14.92
306,311,0,603,613,10,4.05,8.87,14.77
306,312,0,545,553,8,4.19,8.77,14.13
306,312,1,732,740,8,1.27,7.48,13.57
306,312,2,975,984,9,11.61,12.81,14.83
306,313,0,858,863,5,10,11.51,13.4
306,314,0,640,646,6,9.97,11.68,14.25
306,343,0,995,1003,8,4.26,8.75,14.09
307,3,0,1016,1025,9,11.68,12.84,14.85
307,66,0,966,974,8,10.44,11.85,13.77
307,66,1,1005,1028,23,8.01,10.58,14.69
307,286,0,727,736,9,3.46,8.73,14.87
307,287,0,725,732,7,1.32,7.58,14.31
307,291,0,699,699,0,7.06,7.06,7.06
307,293,0,749,756,7,1.21,6.95,12.7
307,293,1,804,805,1,14.89,14.9,14.92
307,294,0,699,699,0,14.4,14.4,14.4
307,294,1,721,730,9,2.8,8.06,14.49
307,296,0,736,756,20,2.26,8.57,14.99
307,300,0,622,628,6,9.58,11.52,14.15
307,300,1,841,849,8,5.83,9.47,14.92
307,301,0,659,664,5,9.92,11.65,14.09
307,301,1,836,836,0,12.14,12.14,12.14
307,301,2,839,849,10,9.92,11.61,14.11
307,301,3,959,967,8,9.02,11.35,14.47
307,302,0,599,607,8,7.72,10.71,14.86
307,303,0,597,601,4,13.23,13.94,14.94
307,303,1,894,905,11,8.69,11.15,14.78
307,305,0,484,496,12,3.85,9.06,14.85
307,305,1,616,629,13,4.2,8.61,14.16
307,305,2,638,670,32,3.86,8.59,14.93
307,305,3,929,938,9,3.82,8.73,14.4
307,306,0,943,950,7,7.51,10.09,13.67
307,306,1,1051,1065,14,9.44,11.64,14.87
307,308,0,577,582,5,11.71,12.65,13.94
307,308,1,1016,1029,13,11.11,12.35,14.95
307,309,0,610,616,6,6.16,9.68,14.09
307,309,1,843,851,8,4.5,8.21,13.8
307,310,0,666,673,7,11.49,12.68,14.62
307,310,1,834,834,0,13.91,13.91,13.91
307,311,0,953,956,3,13.49,13.91,14.48
307,312,0,845,852,7,2.07,7.01,12.07
307,313,0,443,444,1,13.65,14.17,14.69
307,313,1,448,457,9,11.45,12.72,14.55
307,313,2,555,561,6,12.63,13.53,14.92
307,313,3,667,674,7,3.63,8.75,14.39
307,313,4,926,938,12,5.32,9.13,14.16
307,313,5,1062,1069,7,4.32,8.81,14.83
307,314,0,579,581,2,14.16,14.38,14.68
307,314,1,885,891,6,13.06,13.75,14.99
308,301,0,486,507,21,7.08,10.15,14.75
308,302,0,547,556,9,2.09,7.81,14.15
308,302,1,746,747,1,14.63,14.8,14.97
308,302,2,891,910,19,12.97,13.7,14.93
308,303,0,550,558,8,2.47,7.7,13.42
308,303,1,815,817,2,14.39,14.65,14.95
308,304,0,462,485,23,10.79,12.88,14.91
308,304,1,533,547,14,1.74,7.82,14.81
308,305,0,544,554,10,9.84,11.72,14.46
308,306,0,651,668,17,8.44,10.55,14.28
308,307,0,577,582,5,11.71,12.65,13.94
308,307,1,1016,1021,5,11.12,12.27,14.62
308,310,0,544,546,2,14.49,14.62,14.75
308,311,0,445,478,33,7.16,9.79,14.65
308,312,0,777,784,7,8.64,11.03,14.79
308,313,0,706,716,10,8.56,10.98,14.44
308,313,1,759,776,17,9.51,11.59,14.91
308,313,2,975,979,4,13.4,13.89,14.55
308,314,0,555,626,71,1.88,8.22,14.89
308,314,1,808,816,8,0.83,7.26,13.66
308,314,2,999,1006,7,7.35,10.08,13.66
309,43,0,795,801,6,11.14,12.74,14.86
309,300,0,559,566,7,3.09,7.61,12.69
309,300,1,843,846,3,5.87,9.47,13.51
309,301,0,843,847,4,11.78,12.56,14.01
309,302,0,512,520,8,7,9.9,13.96
309,302,1,1025,1031,6,7.88,10.39,13.56
309,303,0,665,674,9,1.46,8.05,14.95
309,303,1,889,897,8,9.64,11.73,14.62
309,304,0,623,632,9,9.57,11.5,14.4
309,307,0,610,616,6,6.16,9.68,14.09
309,307,1,843,851,8,4.5,8.21,13.8
309,310,0,576,586,10,7,10.25,14.89
309,310,1,921,936,15,9.73,11.57,14.35
309,312,0,703,715,12,2.04,8.23,14.75
309,312,1,843,851,8,7.6,10.53,14.5
309,313,0,520,527,7,4.54,9.29,14.6
309,314,0,652,658,6,10.53,11.95,14.08
309,314,1,985,992,7,6.92,9.97,14.33
309,343,0,1020,1023,3,13.87,14.23,14.79
310,301,0,748,760,12,13.66,14.14,14.89
310,301,1,783,794,11,7.83,10.57,14.19
310,301,2,905,911,6,12.83,13.58,14.91
310,302,0,541,546,5,13.62,14.14,14.87
310,302,1,827,835,8,11.71,13.01,14.81
310,305,0,540,551,11,5.37,8.88,13.54
310,305,1,663,675,12,2.54,7.8,14.07
310,305,2,739,798,59,8.12,10.77,14.84
310,306,0,815,826,11,4.37,8.9,14.98
310,306,1,852,877,25,11.07,12.47,14.92
310,307,0,666,673,7,11.49,12.68,14.62
310,307,1,834,834,0,13.91,13.91,13.91
310,308,0,544,546,2,14.49,14.62,14.75
310,309,0,576,586,10,7,10.25,14.89
310,309,1,921,936,15,9.73,11.57,14.35
310,311,0,715,732,17,1.73,7.86,14.72
310,313,0,671,682,11,9.82,11.56,14.18
310,313,1,855,858,3,13.42,13.82,14.34
310,314,0,547,556,9,6.41,10,14.96
311,300,0,503,511,8,7.92,10.63,14.58
311,300,1,804,813,9,0.63,7.2,13.78
311,301,0,478,488,10,11.17,12.58,14.61
311,301,1,628,636,8,5.67,9.52,14.35
311,301,2,937,946,9,2.14,8.16,14.4
311,302,0,556,563,7,1.6,7.01,12.48
311,302,1,671,680,9,8.74,10.99,14.5
311,302,2,872,882,10,2.34,7.65,13.74
311,303,0,557,565,8,1.38,7.81,14.7
311,303,1,846,851,5,10.84,12.16,13.83
311,304,0,456,464,8,13.39,13.92,14.67
311,304,1,868,874,6,12.13,13.05,14.56
311,304,2,1024,1033,9,10.07,11.84,14.38
311,305,0,557,565,8,6.83,9.87,13.98
311,305,1,894,903,9,3.44,8.22,13.71
311,306,0,603,613,10,4.05,8.87,14.77
311,307,0,953,956,3,13.49,13.91,14.48
311,308,0,450,478,28,7.16,9.37,14.43
311,310,0,715,732,17,1.73,7.86,14.72
311,312,0,692,700,8,2.48,7.91,14.14
311,313,0,626,636,10,8.9,10.95,13.85
311,313,1,1037,1048,11,2.02,8.82,14.27
311,314,0,842,848,6,8.49,10.6,13.39
312,81,0,914,919,5,10,11.31,12.91
312,300,0,817,835,18,2.33,9.65,14.39
312,300,1,838,849,11,13.29,13.79,14.56
312,301,0,454,461,7,9.52,11.45,14.39
312,301,1,848,852,4,9.95,11.49,14.25
312,302,0,493,503,10,3.83,8.47,13.76
312,302,1,979,993,14,0.6,7.64,14.64
312,303,0,674,680,6,10.65,12.2,14.97
312,303,1,974,974,0,14.97,14.97,14.97
312,304,0,626,658,32,6.08,9.63,14.95
312,305,0,600,610,10,2.02,7.76,14.38
312,306,0,545,553,8,4.19,8.77,14.13
312,306,1,732,740,8,1.27,7.48,13.57
312,306,2,975,984,9,11.61,12.81,14.83
312,307,0,845,852,7,2.07,7.01,12.07
312,308,0,777,784,7,8.64,11.03,14.79
312,309,0,703,715,12,2.04,8.23,14.75
312,309,1,843,851,8,7.6,10.53,14.5
312,311,0,692,700,8,2.48,7.91,14.14
312,314,0,657,666,9,4.27,8.47,13.66
313,301,0,631,642,11,1.85,7.94,14.71
313,301,1,703,707,4,13.61,14.16,14.9
313,302,0,849,855,6,2.56,7.5,12.06
313,303,0,1011,1019,8,8.36,10.92,14.24
313,305,0,928,937,9,1.61,8.03,14.81
313,306,0,858,863,5,10,11.51,13.4
313,306,1,1066,1077,11,8.07,10.43,13.89
313,307,0,555,561,6,12.63,13.53,14.92
313,307,1,667,674,7,3.63,8.75,14.39
313,307,2,926,938,12,5.32,9.13,14.16
313,307,3,1062,1069,7,4.32,8.81,14.83
313,308,0,706,716,10,8.56,10.98,14.44
313,308,1,759,776,17,9.51,11.59,14.91
313,308,2,975,979,4,13.4,13.89,14.55
313,309,0,520,527,7,4.54,9.29,14.6
313,310,0,671,682,11,9.82,11.56,14.18
313,310,1,855,858,3,13.42,13.82,14.34
313,311,0,626,636,10,8.9,10.95,13.85
313,311,1,1037,1048,11,2.02,8.51,14.27
314,93,0,1013,1022,9,4.74,8.88,13.85
314,300,0,696,717,21,3.69,9.16,14.9
314,301,0,524,528,4,11.48,12.52,13.77
314,301,1,695,698,3,14.03,14.49,14.96
314,301,2,1033,1044,11,11.06,12.65,15
314,302,0,464,471,7,2.65,8.2,14.32
314,302,1,725,726,1,14.87,14.9,14.92
314,303,0,632,639,7,5.48,9.16,14.07
314,303,1,712,719,7,5.3,9.01,13.79
314,304,0,661,666,5,13.59,14.13,14.94
314,304,1,779,789,10,1.12,7.67,14.99
314,305,0,500,501,1,14.95,14.96,14.97
314,305,1,545,555,10,7.81,10.3,13.72
314,306,0,640,646,6,9.97,11.68,14.25
314,307,0,579,581,2,14.16,14.38,14.68
314,307,1,885,891,6,13.06,13.75,14.99
314,308,0,555,626,71,1.88,8.36,14.89
314,308,1,808,816,8,0.83,7.26,13.66
314,308,2,999,1006,7,7.35,10.08,13.66
314,309,0,652,658,6,10.53,11.95,14.08
314,309,1,985,992,7,6.92,9.97,14.33
314,310,0,547,556,9,6.41,10,14.96
314,311,0,842,848,6,8.49,10.6,13.39
314,312,0,657,666,9,4.27,8.47,13.66
314,343,0,949,949,0,12.68,12.68,12.68
315,316,0,914,918,4,12.47,13.3,14.3
315,317,0,601,609,8,11.59,12.84,14.58
315,318,0,855,868,13,2.1,7.4,13.21
315,318,1,927,1013,86,2.7,7.84,15
315,319,0,936,948,12,11.43,12.66,14.57
315,320,0,698,735,37,0.6,7.56,14.97
315,320,1,886,895,9,3.87,8.97,14.98
315,322,0,534,545,11,6.35,9.94,14.77
315,323,0,533,543,10,2.13,7.82,14.42
315,323,1,913,925,12,3.8,8.16,13.3
315,323,2,1046,1053,7,4.55,8.31,12.78
315,324,0,487,500,13,3.98,8.39,14.02
315,324,1,644,648,4,13.81,14.12,14.44
315,325,0,935,954,19,7.75,10.61,14.72
315,326,0,558,560,2,14.53,14.65,14.8
315,327,0,515,528,13,1.74,8.12,14.54
315,328,0,814,824,10,3.34,8.93,14.57
315,329,0,825,874,49,2.09,9.02,14.86
315,329,1,1035,1043,8,7.42,10.38,14.62
316,315,0,914,918,4,12.47,13.3,14.3
316,317,0,648,652,4,12.41,13.33,14.41
316,317,1,992,992,0,14.43,14.43,14.43
316,318,0,480,488,8,2.7,8.41,13.88
316,318,1,580,586,6,3.59,7.93,12.92
316,318,2,679,684,5,5.16,8.4,13.91
316,319,0,686,694,8,8.06,10.54,13.64
316,320,0,570,576,6,7.24,9.9,12.91
316,320,1,827,840,13,1.11,7.86,14.85
316,320,2,951,957,6,10.71,12.36,14.88
316,321,0,628,635,7,4.22,9.17,14.98
316,321,1,719,726,7,8.4,10.66,13.64
316,322,0,494,498,4,13.53,14.12,14.84
316,322,1,628,631,3,13.55,13.87,14.23
316,322,2,762,764,2,14.21,14.4,14.52
316,322,3,896,897,1,14.65,14.72,14.78
316,322,4,1029,1038,9,11.11,12.46,14.72
316,323,0,497,501,4,11.79,12.99,14.91
316,323,1,585,594,9,2.7,7.98,13.77
316,323,2,910,919,9,3.58,7.76,12.56
316,324,0,681,686,5,12.3,13.2,14.68
316,324,1,787,795,8,7.57,10.3,13.76
316,325,0,849,860,11,8.45,10.82,14.25
316,326,0,505,512,7,10.01,11.53,13.63
316,326,1,804,804,0,3.83,3.83,3.83
316,327,0,461,469,8,11.53,12.77,14.72
316,327,1,486,494,8,10.82,12.18,14.14
316,327,2,613,620,7,10.11,11.88,14.41
316,328,0,455,483,28,1.12,9.67,11.92
316,328,1,486,494,8,13.51,14.17,14.84
316,328,2,623,630,7,13.19,13.85,14.9
316,329,0,688,691,3,13.33,13.9,14.77
316,329,1,1000,1017,17,1.43,9.32,14.5
317,169,0,904,907,3,13.83,14.17,14.58
317,315,0,601,609,8,11.59,12.84,14.58
317,316,0,648,652,4,12.41,13.33,14.41
317,316,1,992,992,0,14.43,14.43,14.43
317,318,0,1019,1029,10,2.81,8.13,14.12
317,319,0,489,514,25,11.32,12.57,14.76
317,319,1,1046,1064,18,2.84,8.36,14.38
317,320,0,815,825,10,1.17,7.49,14.44
317,321,0,880,880,0,6.59,6.59,6.59
317,321,1,886,895,9,1.26,7.59,13.93
317,322,0,480,490,10,11.86,12.96,14.56
317,322,1,670,684,14,0.56,7.34,14.22
317,323,0,805,815,10,2.19,7.85,13.73
317,324,0,826,837,11,6.51,9.94,14.97
317,324,1,993,1002,9,1.13,6.93,14.64
317,325,0,570,575,5,14.07,14.31,14.65
317,325,1,775,794,19,2.95,8.15,14.34
317,326,0,611,618,7,13.97,14.36,14.91
317,328,0,1040,1063,23,5.99,9.45,14.67
317,330,0,884,884,0,10.31,10.31,10.31
317,330,1,897,904,7,3.68,8.43,13.79
318,126,0,724,742,18,6.49,10.07,14.99
318,215,0,694,694,0,8.37,8.37,8.37
318,215,1,800,802,2,13.47,14.12,14.77
318,315,0,855,868,13,2.1,7.4,13.21
318,315,1,927,1013,86,2.7,7.78,15
318,316,0,480,488,8,2.7,8.71,13.88
318,316,1,580,586,6,3.59,7.93,12.92
318,316,2,679,684,5,5.16,8.4,13.91
318,317,0,1019,1029,10,2.81,8.13,14.12
318,319,0,450,463,13,1.97,7.78,14.23
318,319,1,629,639,10,8.95,11.09,14.3
318,319,2,655,675,20,3.69,8.43,14.73
318,319,3,936,954,18,3.43,8.37,14.56
318,320,0,634,641,7,6.42,9.91,14.13
318,322,0,449,456,7,13.02,13.74,14.85
318,323,0,503,505,2,13.75,14.13,14.48
318,323,1,662,670,8,2.44,7.94,14.7
318,323,2,920,931,11,3.45,8.26,13.79
318,324,0,529,537,8,13.11,13.88,14.96
318,324,1,595,611,16,4.6,8.74,14.46
318,324,2,678,684,6,6.1,10.25,14.92
318,325,0,610,623,13,3.38,8.5,14.96
318,325,1,942,958,16,6.07,9.76,14.45
318,326,0,441,450,9,11.51,12.79,14.66
318,327,0,472,481,9,8.56,10.99,14.37
318,327,1,499,514,15,2.05,7.57,13.69
318,328,0,471,483,12,9.61,11.13,14.44
318,328,1,486,492,6,1.44,5.91,12.66
318,328,2,589,594,5,9.99,11.83,14.8
318,328,3,832,841,9,4.37,8.6,13.63
318,329,0,652,655,3,14.14,14.54,14.99
318,329,1,858,873,15,5.31,9.18,14.73
318,329,2,1036,1037,1,14.55,14.6,14.66
319,315,0,936,948,12,11.43,12.66,14.57
319,316,0,686,694,8,8.06,10.54,13.64
319,317,0,489,514,25,11.32,12.57,14.76
319,317,1,1046,1056,10,2.84,7.1,14.38
319,318,0,451,463,12,1.97,7.33,14.23
319,318,1,629,639,10,8.95,11.09,14.3
319,318,2,655,675,20,3.69,8.43,14.73
319,318,3,936,954,18,3.43,8.37,14.56
319,320,0,615,624,9,5.49,8.56,12.8
319,321,0,543,553,10,7.94,10.42,13.94
319,321,1,840,850,10,3.3,7.46,14.6
319,322,0,456,478,22,7.22,10.17,14.7
319,323,0,660,673,13,1.89,7.63,14.15
319,325,0,935,962,27,10.62,12.24,14.93
319,326,0,805,805,0,11.51,11.51,11.51
319,326,1,834,849,15,0.75,7.24,14.1
319,328,0,1042,1056,14,8.63,11.09,14.59
319,329,0,642,647,5,14.01,14.38,14.86
319,329,1,680,701,21,7.91,10.66,14.9
319,329,2,776,789,13,4.48,8.57,13.96
320,315,0,698,735,37,0.6,7.67,14.97
320,315,1,886,895,9,3.87,8.97,14.98
320,316,0,570,576,6,7.24,9.9,12.91
320,316,1,827,840,13,1.11,7.86,14.85
320,316,2,951,957,6,10.71,12.36,14.88
320,317,0,815,825,10,1.17,7.49,14.44
320,318,0,634,641,7,6.42,9.91,14.13
320,319,0,615,625,10,5.49,9.04,13.91
320,321,0,758,765,7,5.71,9.28,13.68
320,323,0,656,656,0,14.98,14.98,14.98
320,323,1,974,980,6,4.03,8.13,14.3
320,325,0,596,609,13,2.29,7.84,14.4
320,325,1,661,669,8,13.17,13.78,14.82
320,326,0,1012,1020,8,2.85,7.67,12.9
320,327,0,741,746,5,14.31,14.49,14.74
320,328,0,581,582,1,14.88,14.9,14.92
320,328,1,745,761,16,4.68,8.83,14.47
320,329,0,449,486,37,5.5,9.53,14.19
321,315,0,445,453,8,11.58,12.65,14.16
321,316,0,628,635,7,4.22,9.17,14.98
321,316,1,719,726,7,8.4,10.66,13.64
321,317,0,429,431,2,9.65,11.63,13.6
321,317,1,880,880,0,6.59,6.59,6.59
321,317,2,886,895,9,1.26,7.59,13.93
321,319,0,543,553,10,7.94,10.42,13.94
321,319,1,840,850,10,3.3,7.46,14.6
321,320,0,758,765,7,5.71,9.28,13.68
321,324,0,685,691,6,11.97,13.05,14.52
321,325,0,532,542,10,7.17,9.98,13.95
321,326,0,430,441,11,7.78,10.18,13.57
321,326,1,572,590,18,5.69,9.52,14.85
321,326,2,660,666,6,10.91,12.23,13.85
321,326,3,806,806,0,14.29,14.29,14.29
321,326,4,819,850,31,5.82,10.81,14.8
321,327,0,659,680,21,9.05,11.34,14.85
321,328,0,633,639,6,9.17,10.92,12.98
321,328,1,1012,1021,9,9.78,11.7,14.91
321,329,0,523,528,5,10.43,11.91,13.79
321,330,0,884,884,0,13.6,13.6,13.6
322,315,0,534,545,11,6.35,9.94,14.77
322,316,0,494,498,4,13.53,14.12,14.84
322,316,1,628,631,3,13.55,13.87,14.23
322,316,2,762,764,2,14.21,14.4,14.52
322,316,3,896,897,1,14.65,14.72,14.78
322,317,0,480,490,10,11.86,12.96,14.56
322,317,1,670,684,14,0.56,7.34,14.22
322,318,0,455,456,1,14.26,14.56,14.85
322,319,0,456,478,22,7.22,10.17,14.7
322,323,0,532,549,17,2.15,7.91,14.65
322,323,1,717,726,9,5.5,9.63,14.69
322,325,0,883,920,37,4.41,9.74,14.96
322,328,0,499,504,5,12.52,13.32,14.48
322,328,1,634,661,27,6.78,9.99,14.72
323,315,0,533,543,10,2.13,7.82,14.42
323,315,1,913,925,12,3.8,8.16,13.3
323,315,2,1046,1053,7,4.55,8.31,12.78
323,316,0,497,501,4,11.79,12.99,14.91
323,316,1,585,594,9,2.7,7.98,13.77
323,316,2,910,919,9,3.58,7.76,12.56
323,317,0,805,815,10,2.19,7.85,13.73
323,318,0,503,505,2,13.75,14.13,14.48
323,318,1,662,670,8,2.44,7.94,14.7
323,318,2,920,931,11,3.45,8.26,13.79
323,319,0,660,673,13,1.89,7.63,14.15
323,320,0,656,656,0,14.98,14.98,14.98
323,320,1,973,980,7,4.03,8.75,14.3
323,322,0,532,549,17,2.15,7.91,14.65
323,322,1,717,726,9,5.5,9.63,14.69
323,324,0,636,652,16,6.18,9.45,13.94
323,324,1,885,894,9,4.36,8.24,12.84
323,325,0,643,648,5,13.45,13.99,14.75
323,326,0,477,491,14,10.32,11.98,14.56
323,327,0,497,504,7,11.63,12.86,14.74
323,327,1,841,850,9,2.06,7.47,13.11
323,327,2,880,906,26,2.17,8,14.94
323,328,0,502,504,2,13.76,14.09,14.6
323,328,1,951,962,11,2.47,7.93,14.1
323,329,0,671,679,8,3.09,8.14,14.07
323,329,1,930,937,7,3.73,8.47,14.68
324,315,0,487,500,13,3.98,8.39,14.02
324,315,1,644,648,4,13.81,14.12,14.44
324,316,0,681,686,5,12.3,13.2,14.68
324,316,1,787,795,8,7.57,10.3,13.76
324,317,0,826,837,11,6.51,9.94,14.97
324,317,1,993,1002,9,1.13,6.93,14.64
324,318,0,529,537,8,13.11,13.88,14.96
324,318,1,595,611,16,4.6,8.74,14.46
324,318,2,678,684,6,6.1,10.25,14.92
324,321,0,685,691,6,11.97,13.05,14.52
324,323,0,636,652,16,6.18,9.45,13.94
324,323,1,885,894,9,4.36,8.24,12.84
324,327,0,878,895,17,4.83,9.09,14.86
324,328,0,581,590,9,6.71,9.99,14.58
324,329,0,604,616,12,7.51,10.47,14.61
324,329,1,696,711,15,5.39,9.04,14.09
324,329,2,791,804,13,3.76,8.37,14.03
324,329,3,984,986,2,14.59,14.68,14.79
325,315,0,935,954,19,7.75,10.45,14.72
325,316,0,849,860,11,8.45,10.82,14.25
325,317,0,570,575,5,14.07,14.31,14.65
325,317,1,775,794,19,2.95,8.15,14.34
325,318,0,610,623,13,3.38,8.5,14.96
325,318,1,942,958,16,6.07,9.52,14.45
325,319,0,935,962,27,10.62,12.21,14.93
325,320,0,596,609,13,2.29,7.84,14.4
325,320,1,661,669,8,13.17,13.78,14.82
325,321,0,532,542,10,7.17,9.98,13.95
325,322,0,883,920,37,4.41,9.61,14.96
325,323,0,643,648,5,13.45,13.99,14.75
325,326,0,1046,1050,4,6.85,10.75,14.68
325,328,0,714,735,21,1.15,9.57,14.98
325,328,1,1005,1017,12,7.12,9.94,13.97
325,329,0,474,480,6,13.51,14,14.85
325,329,1,494,514,20,4.86,9.01,14.57
326,315,0,558,560,2,14.53,14.65,14.8
326,316,0,505,512,7,10.01,11.53,13.63
326,316,1,804,804,0,3.83,3.83,3.83
326,317,0,611,618,7,13.97,14.36,14.91
326,319,0,805,805,0,11.51,11.51,11.51
326,319,1,834,849,15,0.75,7.64,14.1
326,320,0,1012,1020,8,2.85,8.04,12.9
326,321,0,572,590,18,5.69,9.52,14.85
326,321,1,660,666,6,10.91,12.23,13.85
326,321,2,806,806,0,14.29,14.29,14.29
326,321,3,819,850,31,5.82,10.79,14.8
326,321,4,1052,1061,9,11.05,12.4,14.57
326,323,0,477,491,14,10.32,11.98,14.56
326,325,0,1046,1060,14,3.16,8.46,14.68
326,327,0,653,669,16,0.99,7.85,14.81
326,328,0,511,519,8,10.35,12.01,14.89
326,329,0,967,975,8,0.85,7.9,14.55
327,315,0,515,528,13,1.74,7.73,14.54
327,316,0,422,446,24,7.56,9.88,14.6
327,316,1,461,469,8,11.53,12.77,14.72
327,316,2,486,494,8,10.82,12.18,14.14
327,316,3,613,620,7,10.11,11.88,14.41
327,318,0,472,481,9,8.56,10.99,14.37
327,318,1,499,514,15,2.05,7.57,13.69
327,320,0,741,746,5,14.31,14.49,14.74
327,320,1,1047,1079,32,0.36,7.36,14.61
327,321,0,659,680,21,9.05,11.34,14.85
327,323,0,497,504,7,11.63,12.86,14.74
327,323,1,841,850,9,2.06,7.47,13.11
327,323,2,880,906,26,2.17,8,14.94
327,324,0,878,895,17,4.83,9.09,14.86
327,326,0,653,669,16,0.99,7.85,14.81
327,328,0,463,476,13,6.1,9.59,14.26
327,328,1,616,624,8,10.93,12.23,14.17
327,328,2,683,705,22,6.21,9.72,14.73
327,328,3,739,752,13,2.63,8.16,14.39
327,328,4,865,877,12,5.66,9.44,14.47
327,328,5,912,930,18,9.33,11.3,14.42
327,328,6,990,1000,10,6.33,10.14,14.95
328,315,0,814,823,9,3.34,8.35,14.57
328,316,0,452,476,24,9.56,10.67,13.17
328,316,1,479,494,15,1.12,11.11,14.84
328,316,2,623,630,7,13.19,13.85,14.9
328,317,0,1040,1041,1,12.85,13.37,13.89
328,318,0,471,492,21,1.44,9.49,14.44
328,318,1,589,594,5,9.99,11.83,14.8
328,318,2,832,841,9,4.37,8.6,13.63
328,320,0,581,582,1,14.88,14.9,14.92
328,320,1,745,761,16,4.68,8.83,14.47
328,321,0,633,639,6,9.17,10.92,12.98
328,321,1,1012,1021,9,9.78,11.7,14.91
328,322,0,499,504,5,12.52,13.32,14.48
328,322,1,634,661,27,6.78,10.12,14.72
328,323,0,502,504,2,13.76,14.09,14.6
328,323,1,951,962,11,2.47,7.93,14.1
328,324,0,581,590,9,6.71,9.99,14.58
328,325,0,714,735,21,1.15,9.8,14.98
328,325,1,1005,1017,12,7.12,9.94,13.97
328,326,0,511,519,8,10.35,12.01,14.89
328,327,0,463,476,13,6.1,9.59,14.26
328,327,1,616,624,8,10.93,12.23,14.17
328,327,2,683,705,22,6.21,9.72,14.73
328,327,3,739,752,13,2.63,8.16,14.39
328,327,4,865,877,12,5.66,9.44,14.47
328,327,5,912,930,18,9.33,11.3,14.42
328,327,6,990,1000,10,6.33,10.14,14.95
328,329,0,442,443,1,13.11,14,14.89
328,329,1,938,946,8,3.23,8.2,13.95
329,315,0,825,874,49,2.09,9.06,14.86
329,315,1,1035,1043,8,7.42,10.38,14.62
329,316,0,688,691,3,13.33,13.9,14.77
329,316,1,1000,1017,17,1.43,9.16,14.5
329,318,0,652,655,3,14.14,14.54,14.99
329,318,1,858,873,15,5.31,9.18,14.73
329,318,2,1036,1037,1,14.55,14.6,14.66
329,319,0,642,647,5,14.01,14.38,14.86
329,319,1,680,701,21,7.91,10.66,14.9
329,319,2,776,789,13,4.48,8.57,13.96
329,319,3,1064,1066,2,14.72,14.78,14.86
329,320,0,459,486,27,6.91,9.79,13.09
329,321,0,523,528,5,10.43,11.91,13.79
329,323,0,671,679,8,3.09,8.14,14.07
329,323,1,930,937,7,3.73,8.47,14.68
329,324,0,604,616,12,7.51,10.47,14.61
329,324,1,696,711,15,5.39,9.04,14.09
329,324,2,791,804,13,3.76,8.37,14.03
329,324,3,984,986,2,14.59,14.68,14.79
329,325,0,474,480,6,13.51,14,14.85
329,325,1,494,514,20,4.86,9.01,14.57
329,326,0,967,975,8,0.85,7.9,14.55
329,328,0,938,946,8,3.23,8.2,13.95
329,328,1,1060,1071,11,7.35,9.56,14.29
330,169,0,891,897,6,12.25,13.15,14.25
330,317,0,884,884,0,10.31,10.31,10.31
330,317,1,897,904,7,3.68,8.43,13.79
330,321,0,884,884,0,13.6,13.6,13.6
330,331,0,753,763,10,8.98,11.06,14.16
330,331,1,819,850,31,0.67,6.72,14.5
330,333,0,1076,1077,1,12.11,12.97,13.82
330,334,0,434,440,6,8.13,11.29,14.47
330,334,1,845,850,5,4.9,9.35,13.81
330,334,2,1077,1077,0,14.96,14.96,14.96
330,335,0,580,592,12,7.52,10.24,14.32
330,336,0,636,668,32,13.75,14.22,15
330,336,1,749,758,9,9.38,11.36,14.1
330,336,2,1023,1031,8,7.68,10.56,14.32
330,337,0,582,588,6,13.23,13.8,14.68
330,338,0,548,562,14,0.69,7.56,14.17
330,339,0,521,531,10,4.99,8.72,13.52
330,340,0,515,529,14,3.82,8.31,13.94
330,340,1,674,684,10,8.48,10.79,14.46
330,341,0,1065,1072,7,13.31,13.89,14.77
330,342,0,684,732,48,3.68,8.49,14.67
330,342,1,992,992,0,11.84,11.84,11.84
330,343,0,537,548,11,2.27,8.04,14.61
330,343,1,779,789,10,5.34,9.12,14.43
330,343,2,792,794,2,14.9,14.93,14.97
330,344,0,548,559,11,2.99,8.44,14.69
330,344,1,776,783,7,9.39,11.55,14.82
330,344,2,824,843,19,10.98,12.47,14.96
331,330,0,753,763,10,8.98,11.06,14.16
331,330,1,819,850,31,0.67,6.72,14.5
331,332,0,861,873,12,3.09,8.56,14.62
331,334,0,851,871,20,9.35,11.43,14.64
331,335,0,488,502,14,4.28,8.4,13.48
331,336,0,575,585,10,6.76,9.81,14.43
331,336,1,748,763,15,2.44,7.65,13.7
331,337,0,455,477,22,10.8,12.77,14.82
331,338,0,445,466,21,5.91,9.31,14.74
331,338,1,1005,1026,21,3.57,8.15,14.77
331,340,0,601,607,6,11.68,12.71,14
331,340,1,944,945,1,14.81,14.87,14.94
331,343,0,491,499,8,12.24,13.19,14.65
331,344,0,813,840,27,4.95,9.02,14.91
332,331,0,861,873,12,3.09,8.56,14.62
332,334,0,866,876,10,9.65,11.62,14.91
332,334,1,995,1004,9,10.95,12.45,14.74
332,336,0,875,886,11,12.34,13.26,14.82
332,337,0,456,457,1,13.79,14.39,14.99
332,337,1,714,726,12,3.15,8.3,14.68
332,337,2,981,993,12,1.12,7.49,14.65
332,338,0,464,474,10,9.76,11.74,14.87
332,338,1,572,609,37,5.55,9.35,14.95
332,339,0,779,790,11,5.54,9.58,14.9
332,339,1,901,906,5,13.32,13.9,14.88
332,340,0,783,792,9,8.76,10.72,13.5
332,341,0,750,773,23,13.34,13.87,14.77
332,341,1,829,851,22,3.68,8.45,14.83
332,344,0,479,490,11,4.09,8.26,13.36
332,344,1,976,977,1,14.74,14.86,14.97
332,344,2,981,985,4,13.54,13.95,14.52
332,344,3,1006,1028,22,12.04,13.11,14.94
333,16,0,875,887,12,2.7,8.1,14.61
333,18,0,865,865,0,2.18,2.18,2.18
333,26,0,867,867,0,10.83,10.83,10.83
333,26,1,874,903,29,1.71,8.12,14.56
333,28,0,864,864,0,7.65,7.65,7.65
333,129,0,866,866,0,10.71,10.71,10.71
333,266,0,865,865,0,14.53,14.53,14.53
333,332,0,969,969,0,10.13,10.13,10.13
333,334,0,502,508,6,13.51,14.14,14.99
333,334,1,665,670,5,14,14.36,14.89
333,336,0,502,514,12,0.55,7.71,14.77
333,337,0,664,681,17,5.46,9.13,14.1
333,338,0,534,547,13,5.07,8.96,14.37
333,339,0,510,513,3,14.71,14.84,14.99
333,342,0,591,606,15,6.57,10,14.7
333,342,1,972,972,0,13.61,13.61,13.61
333,342,2,1009,1025,16,10.99,12.37,14.78
333,343,0,525,537,12,4.67,9.09,14.65
333,344,0,539,548,9,5.22,9.14,14.21
334,330,0,845,850,5,4.9,9.35,13.81
334,331,0,851,871,20,9.35,11.43,14.64
334,332,0,866,876,10,9.65,11.62,14.91
334,332,1,995,1004,9,10.95,12.45,14.74
334,332,2,1061,1074,13,11.11,12.37,14.4
334,333,0,502,508,6,13.51,14.14,14.99
334,333,1,665,670,5,14,14.36,14.89
334,333,2,1067,1074,7,6.47,9.93,13.94
334,335,0,620,630,10,10.31,11.89,14.42
334,336,0,509,533,24,6.9,10.08,14.96
334,336,1,939,947,8,10.43,12.31,14.81
334,337,0,663,672,9,8.97,11.3,14.59
334,337,1,893,904,11,5.82,9.65,14.73
334,337,2,1010,1015,5,13.36,13.97,14.71
334,339,0,513,520,7,10.59,12.04,14.15
334,339,1,620,625,5,12.98,13.72,14.92
334,339,2,727,728,1,14.75,14.76,14.76
334,340,0,506,516,10,0.74,7.47,14.13
334,340,1,726,731,5,12.59,13.27,14.22
334,340,2,1057,1074,17,5.46,8.8,14.85
334,341,0,607,610,3,14.49,14.62,14.79
334,341,1,898,931,33,0.8,7.15,14.44
334,342,0,899,904,5,12.9,13.49,14.36
334,343,0,1062,1062,0,11.27,11.27,11.27
334,344,0,584,589,5,12.19,13.36,14.9
334,344,1,712,716,4,14.22,14.52,14.86
334,344,2,839,847,8,11.89,13.02,14.7
334,344,3,1003,1007,4,12.93,13.48,14.22
335,330,0,580,592,12,7.52,10.24,14.32
335,331,0,488,502,14,4.28,8.4,13.48
335,334,0,620,630,10,10.31,11.89,14.42
335,336,0,595,596,1,14.77,14.78,14.79
335,336,1,831,876,45,7.45,10.26,14.84
335,337,0,497,500,3,14.55,14.66,14.78
335,337,1,559,581,22,0.46,7.34,14.08
335,337,2,931,939,8,13.41,13.9,14.68
335,338,0,639,654,15,2.74,8.42,14.87
335,339,0,628,636,8,11.83,13.01,14.88
335,339,1,805,818,13,1.95,7.82,14.3
335,340,0,612,625,13,8.32,11.02,14.97
335,340,1,814,828,14,9.96,11.7,14.49
335,341,0,663,677,14,6.3,9.8,14.6
335,342,0,927,941,14,7.15,9.97,13.87
335,343,0,493,502,9,10.04,11.87,14.69
335,343,1,740,751,11,2.78,7.69,13.41
335,344,0,445,445,0,14.79,14.79,14.79
335,344,1,743,752,9,4.54,8.52,13.29
335,344,2,859,862,3,13.97,14.25,14.59
336,330,0,636,668,32,13.75,14.22,15
336,330,1,749,758,9,9.38,11.36,14.1
336,330,2,1023,1031,8,7.68,10.56,14.32
336,331,0,575,585,10,6.76,9.81,14.43
336,331,1,748,763,15,2.44,7.65,13.7
336,332,0,875,886,11,12.34,13.26,14.82
336,333,0,502,514,12,0.55,7.71,14.77
336,334,0,509,533,24,6.9,10.08,14.96
336,334,1,939,947,8,10.43,12.31,14.81
336,335,0,595,596,1,14.77,14.78,14.79
336,335,1,831,876,45,7.45,10.22,14.84
336,337,0,909,920,11,8.84,10.98,14.21
336,339,0,509,524,15,2.77,8.38,14.77
336,339,1,816,826,10,2.41,7.96,14.29
336,340,0,510,518,8,10.11,11.82,14.43
336,340,1,668,677,9,8.86,11.13,14.61
336,340,2,826,836,10,7.69,10.62,14.72
336,340,3,985,995,10,6.44,9.69,14.14
336,342,0,474,484,10,6.73,9.54,13.48
336,342,1,759,770,11,9.57,11.52,14.38
336,342,2,912,915,3,14.22,14.43,14.71
336,344,0,474,475,1,11.43,13.09,14.74
336,344,1,564,573,9,1.23,7.56,14.19
336,344,2,764,767,3,12.64,13.07,13.51
337,330,0,582,588,6,13.23,13.8,14.68
337,331,0,462,477,15,11.05,12.92,14.82
337,332,0,714,726,12,3.15,8.3,14.68
337,332,1,981,993,12,1.12,7.49,14.65
337,333,0,664,681,17,5.46,9.13,14.1
337,334,0,663,672,9,8.97,11.3,14.59
337,334,1,893,904,11,5.82,9.65,14.73
337,334,2,1010,1015,5,13.36,13.97,14.71
337,335,0,497,500,3,14.55,14.66,14.78
337,335,1,559,581,22,0.46,7.34,14.08
337,335,2,931,939,8,13.41,13.9,14.68
337,336,0,909,920,11,8.84,10.98,14.21
337,339,0,706,711,5,12.6,13.33,14.28
337,341,0,520,546,26,5.13,9.14,14.6
337,341,1,890,896,6,13.63,14.03,14.66
337,342,0,890,927,37,3.74,8.56,14.93
337,343,0,481,495,14,1.56,8.14,14.87
337,343,1,638,657,19,8.05,10.39,14.94
337,344,0,948,970,22,4.96,9.16,14.73
337,344,1,989,1000,11,3.65,9.16,14.58
338,330,0,548,562,14,0.69,7.56,14.17
338,331,0,458,466,8,5.91,8.96,14.02
338,331,1,1005,1026,21,3.57,8.05,14.77
338,332,0,464,474,10,9.76,11.74,14.87
338,332,1,572,609,37,5.55,9.35,14.95
338,333,0,534,547,13,5.07,8.96,14.37
338,335,0,639,654,15,2.74,8.42,14.87
338,339,0,688,705,17,4.02,8.64,14.93
338,340,0,692,707,15,6.17,9.39,13.81
338,342,0,1042,1054,12,13.36,13.91,14.83
338,343,0,824,834,10,8.66,11.24,14.69
338,343,1,1063,1065,2,12.66,13.28,13.92
338,344,0,541,563,22,1.66,7.66,14.51
339,173,0,925,925,0,6.14,6.14,6.14
339,239,0,1001,1009,8,13.42,13.93,14.87
339,330,0,521,531,10,4.99,8.72,13.52
339,332,0,779,790,11,5.54,9.39,14.9
339,332,1,901,906,5,13.32,13.9,14.88
339,333,0,510,513,3,14.71,14.84,14.99
339,334,0,513,520,7,10.59,12.04,14.15
339,334,1,620,625,5,12.98,13.72,14.92
339,334,2,727,728,1,14.75,14.76,14.76
339,335,0,628,636,8,11.83,13.01,14.88
339,335,1,805,818,13,1.95,7.82,14.3
339,336,0,509,524,15,2.77,8.38,14.77
339,336,1,816,826,10,2.41,7.96,14.29
339,337,0,706,711,5,12.6,13.33,14.28
339,338,0,688,705,17,4.02,8.64,14.93
339,340,0,514,530,16,12.47,13.35,14.9
339,340,1,686,779,93,4.19,8.55,14.95
339,340,2,786,809,23,9.18,11.3,14.79
339,341,0,788,800,12,2.57,8.2,14.68
339,342,0,680,689,9,7.6,10.13,13.52
339,343,0,581,594,13,1.43,7.67,14.79
339,343,1,715,724,9,5.45,9.26,14.49
339,343,2,853,863,10,1.06,7.79,14.34
340,330,0,515,529,14,3.82,8.31,13.94
340,330,1,674,684,10,8.48,10.79,14.46
340,331,0,601,607,6,11.68,12.71,14
340,331,1,944,945,1,14.81,14.87,14.94
340,332,0,783,792,9,8.76,10.72,13.5
340,332,1,1031,1043,12,5.3,8.82,14.99
340,334,0,506,516,10,0.74,7.47,14.13
340,334,1,726,731,5,12.59,13.27,14.22
340,335,0,612,625,13,8.32,11.02,14.97
340,335,1,814,828,14,9.96,11.72,14.49
340,336,0,510,518,8,10.11,11.82,14.43
340,336,1,668,677,9,8.86,11.13,14.61
340,336,2,826,836,10,7.69,10.62,14.72
340,336,3,985,995,10,6.44,9.69,14.14
340,338,0,692,707,15,6.17,9.39,13.81
340,339,0,514,530,16,12.47,13.35,14.9
340,339,1,686,779,93,4.19,8.57,14.95
340,339,2,786,809,23,9.18,11.3,14.79
340,341,0,790,807,17,4.57,9.04,14.28
340,341,1,1012,1023,11,11.55,12.75,14.89
340,342,0,677,687,10,6.95,9.79,13.58
340,343,0,716,723,7,11.16,12.52,14.57
340,343,1,880,886,6,13.64,14.09,14.77
340,343,2,906,923,17,10.26,11.83,14.28
340,344,0,1032,1033,1,14.64,14.71,14.77
341,332,0,750,773,23,13.34,13.87,14.77
341,332,1,829,851,22,3.68,8.45,14.83
341,334,0,607,610,3,14.49,14.62,14.79
341,334,1,898,931,33,0.8,7.31,14.44
341,335,0,663,677,14,6.3,9.8,14.6
341,337,0,520,546,26,5.13,9.2,14.6
341,337,1,890,896,6,13.63,14.03,14.66
341,339,0,455,455,0,14.47,14.47,14.47
341,339,1,788,800,12,2.57,8.2,14.68
341,340,0,790,807,17,4.57,9.12,14.28
341,340,1,1012,1023,11,11.55,12.75,14.89
341,343,0,728,739,11,4.58,8.91,14.22
341,344,0,617,624,7,10.52,11.96,14.01
341,344,1,734,742,8,8.58,11.24,14.94
342,330,0,684,732,48,3.68,8.5,14.67
342,330,1,992,992,0,11.84,11.84,11.84
342,333,0,591,606,15,6.57,10,14.7
342,333,1,972,972,0,13.61,13.61,13.61
342,333,2,1009,1025,16,10.99,12.37,14.78
342,334,0,899,904,5,12.9,13.49,14.36
342,335,0,927,941,14,7.15,9.97,13.87
342,336,0,473,484,11,6.73,9.98,14.77
342,336,1,759,770,11,9.57,11.52,14.38
342,336,2,912,915,3,14.22,14.43,14.71
342,337,0,890,927,37,3.74,8.56,14.93
342,339,0,680,689,9,7.6,10.13,13.52
342,340,0,677,687,10,6.95,9.79,13.58
342,343,0,761,774,13,8.81,10.92,14.17
342,344,0,446,466,20,5.05,8.21,14.35
342,344,1,516,525,9,3.9,8.52,13.82
342,344,2,760,770,10,6.64,9.79,14.33
342,344,3,938,942,4,14.08,14.37,14.65
343,3,0,951,951,0,11.65,11.65,11.65
343,93,0,967,970,3,5.68,9.21,14.28
343,245,0,972,978,6,2.34,7.44,12.55
343,300,0,976,987,11,10.73,12.11,14.27
343,305,0,982,992,10,1,8.18,13.92
343,306,0,995,1003,8,4.26,8.75,14.09
343,309,0,1020,1023,3,13.87,14.23,14.79
343,314,0,949,949,0,12.68,12.68,12.68
343,330,0,537,548,11,2.27,8.04,14.61
343,330,1,779,789,10,5.34,9.12,14.43
343,330,2,792,794,2,14.9,14.93,14.97
343,331,0,491,499,8,12.24,13.19,14.65
343,333,0,525,537,12,4.67,9.09,14.65
343,335,0,493,502,9,10.04,11.87,14.69
343,335,1,740,751,11,2.78,7.69,13.41
343,337,0,481,495,14,1.56,8.14,14.87
343,337,1,638,657,19,8.05,10.41,14.94
343,338,0,824,834,10,8.66,11.24,14.69
343,339,0,434,438,4,10.89,12.67,14.65
343,339,1,580,594,14,1.43,8.15,14.97
343,339,2,715,724,9,5.45,9.26,14.49
343,339,3,853,862,9,1.06,7.13,13.67
343,340,0,716,723,7,11.16,12.52,14.57
343,340,1,880,886,6,13.64,14.09,14.77
343,340,2,906,923,17,10.26,11.83,14.28
343,341,0,434,445,11,12.51,13.44,14.96
343,341,1,728,739,11,4.58,8.91,14.22
343,342,0,761,774,13,8.81,10.92,14.17
343,344,0,673,684,11,8.83,11.1,14.27
343,344,1,739,776,37,0.47,7.44,14.58
343,344,2,806,817,11,7.7,10.22,13.89
344,330,0,548,559,11,2.99,8.44,14.69
344,330,1,776,783,7,9.39,11.55,14.82
344,330,2,824,843,19,10.98,12.47,14.96
344,331,0,813,840,27,4.95,9.02,14.91
344,332,0,479,490,11,4.09,8.26,13.36
344,332,1,976,977,1,14.74,14.86,14.97
344,332,2,981,985,4,13.54,13.95,14.52
344,332,3,1006,1028,22,12.04,13.11,14.94
344,333,0,539,548,9,5.22,9.14,14.21
344,334,0,584,589,5,12.19,13.36,14.9
344,334,1,712,716,4,14.22,14.52,14.86
344,334,2,839,847,8,11.89,13.02,14.7
344,334,3,1003,1007,4,12.93,13.48,14.22
344,335,0,435,445,10,7.19,9.77,14.79
344,335,1,743,752,9,4.54,8.52,13.29
344,335,2,859,862,3,13.97,14.25,14.59
344,336,0,463,475,12,3.56,8.02,14.74
344,336,1,564,573,9,1.23,7.56,14.19
344,336,2,764,767,3,12.64,13.07,13.51
344,336,3,1072,1073,1,12.92,13.48,14.04
344,337,0,948,970,22,4.96,9.16,14.73
344,337,1,989,1000,11,3.65,9.54,14.58
344,338,0,541,563,22,1.66,7.66,14.51
344,340,0,1032,1033,1,14.64,14.71,14.77
344,341,0,617,624,7,10.52,11.96,14.01
344,341,1,734,742,8,8.58,11.24,14.94
344,342,0,443,466,23,5.05,8.71,14.35
344,342,1,516,525,9,3.9,8.52,13.82
344,342,2,760,770,10,6.64,9.79,14.33
344,342,3,938,942,4,14.08,14.37,14.65
344,343,0,673,684,11,8.83,11.1,14.27
344,343,1,739,776,37,0.47,7.44,14.58
344,343,2,806,817,11,7.7,10.22,13.89
